Calico City Mystery
An Interactive Fiction by TurtleCorn Productions
Release 1 / Serial number 220628 / Inform 7 build 6M62 (I6/v6.34 lib 6/12N) SD

Bunnies' Bedroom
The Bunnies' Bedroom has a bunkbed against one wall for you and Liam Bunny, and a bed for each parent. Next to the bunkbed is a desk, and in front of the beds is a wardrobe.

To your south is the living room.

>accuse box
That's your best guess? the Box?

>accuse the Box
You can't see any such thing.

* * *

>accuse box
That's your best guess? the Box?

>look dave
You see nothing special about Dave.

* * *

Calico City Mystery
An Interactive Fiction by TurtleCorn Productions
Release 1 / Serial number 220628 / Inform 7 build 6M62 (I6/v6.34 lib 6/12N) SD

Bunnies' Bedroom
The Bunnies' Bedroom has a bunkbed against one wall for you and Liam Bunny, and a bed for each parent. Next to the bunkbed is a desk, and in front of the beds is a wardrobe.

To your south is the living room.

>e
You can't go that way.

>up
Bunny House Dining Room

>w
You can't go that way.

>e
Bunny House Bathroom

* * *

>e
You can't go that way.

>w
You can't go that way.

>s
Bunnies' Living Room

>w
Garden1

>look
Garden1

>x bunny farm
You can't see any such thing.

* * *

Calico City Mystery
An Interactive Fiction by TurtleCorn Productions
Release 1 / Serial number 220628 / Inform 7 build 6M62 (I6/v6.34 lib 6/12N) SD

Bunnies' Bedroom
The Bunnies' Bedroom has a bunkbed against one wall for you and Liam Bunny, and a bed for each parent. Next to the bunkbed is a desk, and in front of the beds is a wardrobe.

To your south is the living room.

>look at wallpaper
The wallpaper is neatly decorated with flowers.

* * *

Calico City Mystery
An Interactive Fiction by TurtleCorn Productions
Release 1 / Serial number 220628 / Inform 7 build 6M62 (I6/v6.34 lib 6/12N) SD

Bunnies' Bedroom
The Bunnies' Bedroom has a bunkbed against one wall for you and Liam Bunny, and a bed for each parent. Next to the bunkbed is a desk, and in front of the beds is a wardrobe.

To your south is the living room.

>look dave
You see nothing special about Dave.

>look liam
You see nothing special about Liam.

>look sylvia
You see nothing special about Sylvia.

>look maeve
You see nothing special about Maeve.

>look marshmallow
they look suspicious.

>accuse marshmallow
That's not a verb I recognise.

>accusing marshmallow
That's not a verb I recognise.

>accus marshmallow
That's not a verb I recognise.

>marshmallow
That's not a verb I recognise.

* * *

Calico City Mystery
An Interactive Fiction by TurtleCorn Productions
Release 1 / Serial number 220628 / Inform 7 build 6M62 (I6/v6.34 lib 6/12N) SD

Bunnies' Bedroom
The Bunnies' Bedroom has a bunkbed against one wall for you and Liam Bunny, and a bed for each parent. Next to the bunkbed is a desk, and in front of the beds is a wardrobe.

To your south is the living room.

>look liam
they don't look suspicious.

>look dave
they don't look suspicious.

>is dave the thief
That's not a verb I recognise.

>accuse dave
That's not a verb I recognise.

* * *

>look dave
they don't look suspicious.

>look sylvia
they don't look suspicious.

>accuse sylvia
Sylvia says "oh, you caught me".

* * *

>look sylvia
they don't look suspicious.

>look maeve
they don't look suspicious.

>look box
You see nothing special about Box.

>look marshmallow
they look suspicious.

>accuse marshmallow
Marshmallow says "oh, you caught me".

* * *

Calico City Mystery
An Interactive Fiction by TurtleCorn Productions
Release 1 / Serial number 220628 / Inform 7 build 6M62 (I6/v6.34 lib 6/12N) SD

Bunnies' Bedroom
The Bunnies' Bedroom has a bunkbed against one wall for you and Liam Bunny, and a bed for each parent. Next to the bunkbed is a desk, and in front of the beds is a wardrobe.

To your south is the living room.

>look region
You can't see any such thing.

>region
That's not a verb I recognise.

>look
Bunny House Bedroom

* * *

Calico City Mystery
An Interactive Fiction by TurtleCorn Productions
Release 1 / Serial number 220628 / Inform 7 build 6M62 (I6/v6.34 lib 6/12N) SD

Bunnies' Bedroom
The Bunnies' Bedroom has a bunkbed against one wall for you and Liam Bunny, and a bed for each parent. Next to the bunkbed is a desk, and in front of the beds is a wardrobe.

To your south is the living room.

>n
You can't go that way.

>s
You can't go that way.

>w
You can't go that way.

>e
You can't go that way.

>talk
That's not a verb I recognise.

>hi
That's not a verb I recognise.

>no
That was a rhetorical question.

>what
That's not a verb I recognise.

* * *

Calico City Mystery
An Interactive Fiction by TurtleCorn Productions
Release 1 / Serial number 220628 / Inform 7 build 6M62 (I6/v6.34 lib 6/12N) SD

Bunnies' Bedroom
The Bunnies' Bedroom has a bunkbed against one wall for you and Liam Bunny, and a bed for each parent. Next to the bunkbed is a desk, and in front of the beds is a wardrobe.

To your south is the living room.

>s
Bunnies' Living Room
The Bunnies' Living Room has a big couch, with two small couches on either side. There is a small coffee table with the TV as well as some toys and books.

To your west is the front door and exit, and there are stairs leading up to the dining room and kitchen. To your north is the bedroom.

>look
Bunnies' Living Room

>w
Playground
placeholder. the playground extends to the south from here.

>n
Playground
placeholder. the playground extends to nothing from here.

>e
You can't go that way.

* * *

>s
Bunnies' Living Room
The Bunnies' Living Room has a big couch, with two small couches on either side. There is a small coffee table with the TV as well as some toys and books.

To your west is the front door and exit, and there are stairs leading up to the dining room and kitchen. To your north is the bedroom.

>up
Bunnies' Dining Room
The dining room table and chairs are wooden, and painted red. On the wall is a broom to help clean up the big messes that Liam Bunny makes. Along the wall is the kitchen.

To your south is the bathroom, and there are stairs leading down to the living room.

>s
Bunnies' Bathroom
The bathroom has all the normal things in a bathroom. On the wall is a laundry machine and a vacuum cleaner. In the bathtub is a toy bath turtle.

To the north is the kitchen and dining room.

>n
Bunnies' Dining Room
The dining room table and chairs are wooden, and painted red. On the wall is a broom to help clean up the big messes that Liam Bunny makes. Along the wall is the kitchen.

To your south is the bathroom, and there are stairs leading down to the living room.

>d
Bunnies' Living Room

>w
Bunnies' Garden.
placeholder. the playground extends to the south from here.

>s
Playground

* * *

>n
Bunnies' Dining Room
The dining room table and chairs are wooden, and painted red. On the wall is a broom to help clean up the big messes that Liam Bunny makes. Along the wall is the kitchen.

To your south is the bathroom, and there are stairs leading down to the living room.

>dow
That's not a verb I recognise.

>d
Bunnies' Living Room
The Bunnies' Living Room has a big couch, with two small couches on either side. There is a small coffee table with the TV as well as some toys and books.

To your west is the front door and exit, and there are stairs leading up to the dining room and kitchen. To your north is the bedroom.

>w
Bunnies' Garden.
This part of the garden contains the stairs leading up to the entrance, and a tree with lots of birds and flowers. There is also a side gate that leads to the Bunnies' outdoor gear.

To your north, the garden continues, and you can see some vegetables and a pond. to your south is the carousel and the playground.

You can see Bunnies' Car (empty) here.

* * *

>s
Bunnies' Bathroom
The bathroom has all the normal things in a bathroom. On the wall is a laundry machine and a vacuum cleaner. In the bathtub is a toy bath turtle.

To the north is the kitchen and dining room.

>take turtle
You can't see any such thing.

>n
Bunnies' Dining Room
The dining room table and chairs are wooden, and painted red. On the wall is a broom to help clean up the big messes that Liam Bunny makes. Along the wall is the kitchen.

To your south is the bathroom, and there are stairs leading down to the living room.

>down
Bunnies' Living Room
The Bunnies' Living Room has a big couch, with two small couches on either side. There is a small coffee table with the TV as well as some toys and books.

To your west is the front door and exit, and there are stairs leading up to the dining room and kitchen. To your north is the bedroom.

>w
Bunnies' Garden.
This part of the garden contains the stairs leading up to the entrance, and a tree with lots of birds and flowers. There is also a side gate that leads to the Bunnies' outdoor gear.

To your north, the garden continues, and you can see some vegetables and a pond. To your south is the carousel and the playground.

You can see Bunnies' Car (empty) here.

>drive car
That's not a verb I recognise.

>get in car
You're not old enough to drive!

>s
Carousel
The carousel is a fun place to hang out, both for the carousel and for the snacks.

To the south is the Playstructure, to the west is the Christmas Theater, and to the north is the Bunnies' Garden.

>on
That's not a verb I recognise.

>ride carousel
You can't see any such thing.

>west
Christmas Theater
The Christmas Theater has a big stage with lots of colorful lights. At the theater, Calicos are encouraged to sing along with their favorite carols!

To your east is the exit out to the Carousel. To your north is the party area, and to your south is the dance party.

>n
Christmas Party Area
In the Christmas Party Area, there is a bunch of Christmas trees and fun activities such as cookie decorating and making ornaments. It is currently a few weeks from Christmas, so the Party Area is feeling very lively. The room is full of holiday food.

To your north is the exit and the road, and to your south is the Christmas Theater.

>eat cookies
You can't see any such thing.

>n
Country Road
This road leads downtown to the southwest. To your south is the Christmas Party Building, and to your east is the Bunny Family's garden.

>e
Bunnies' Garden.
Here you can see Mommy Bunny's vegetable garden, and there are fruits and flowers growing there as well. There is also a cute pond next to the vegetable garden that is a nice place to take a swim.

To your northeast and south the garden continues. To the south is the front door of the house, and to the northeast is the outdoor patio. To your west is the road.

You can see Maeve's Bicycle here.

>ride bike
You mount Maeve's Bicycle.

>w
Country Road (on Maeve's Bicycle)
This road leads downtown to the southwest. To your south is the Christmas Party Building, and to your east is the Bunny Family's garden.

>i
You are carrying nothing.

>do wheelie
That's not a verb I recognise.

>get off
You dismount Maeve's Bicycle.

Country Road
This road leads downtown to the southwest. To your south is the Christmas Party Building, and to your east is the Bunny Family's garden.

You can see Maeve's Bicycle here.

>sw
It's a bit too far to walk from here. Try riding a bike or driving.

>get on
You mount Maeve's Bicycle.

>sw
Banks of the Calico River (on Maeve's Bicycle)
You are on the banks of the Calico River, which runs right through the middle of downtown. The Calico River is one of two rivers in Calico Town, the other being Long River.

The river extends to the west from here. To your south is the Hospital and Doctor's Office, and to your east is the Twisty N. Books Airport (TNB).

>get off
You dismount Maeve's Bicycle.

Banks of the Calico River
You are on the banks of the Calico River, which runs right through the middle of downtown. The Calico River is one of two rivers in Calico Town, the other being Long River.

The river extends to the west from here. To your south is the Hospital and Doctor's Office, and to your east is the Twisty N. Books Airport (TNB).

You can see Maeve's Bicycle here.

>ne
It's a bit too far to walk from here. Try riding a bike or driving.

>get on
You mount Maeve's Bicycle.

>ne
Country Road (on Maeve's Bicycle)
This road leads downtown to the southwest. To your south is the Christmas Party Building, and to your east is the Bunny Family's garden.

>sw
Banks of the Calico River (on Maeve's Bicycle)
You are on the banks of the Calico River, which runs right through the middle of downtown. The Calico River is one of two rivers in Calico Town, the other being Long River.

The river extends to the west from here. To your south is the Hospital and Doctor's Office, and to your east is the Twisty N. Books Airport (TNB).

* * *

>get off
You dismount Maeve's Bicycle.

Banks of the Calico River
You are on the banks of the Calico River, which runs right through the middle of downtown. The Calico River is one of two rivers in Calico Town, the other being Long River.

The river extends to the west from here. To your south is the Hospital and Doctor's Office, and to your east is the Twisty N. Books Airport (TNB).

You can see Maeve's Bicycle here.

>e
Twisty N. Books Airport

>n
You can't go that way.

>n
You can't go that way.

>w
Banks of the Calico River
You are on the banks of the Calico River, which runs right through the middle of downtown. The Calico River is one of two rivers in Calico Town, the other being Long River.

The river extends to the west from here. To your south is the Hospital and Doctor's Office, and to your east is the Twisty N. Books Airport (TNB).

You can see Maeve's Bicycle here.

* * *

>s
Bunnies' Living Room
The Bunnies' Living Room has a big couch, with two small couches on either side. There is a small coffee table with the TV as well as some toys and books.

To your west is the front door and exit, and there are stairs leading up to the dining room and kitchen. To your north is the bedroom.

>w
Bunnies' Garden.
This part of the garden contains the stairs leading up to the entrance, and a tree with lots of birds and flowers. There is also a side gate that leads to the Bunnies' outdoor gear.

To your north, the garden continues, and you can see some vegetables and a pond. To your south is the carousel and the playground.

You can see Bunnies' Car (empty) here.

>get in
You're not old enough to drive!

>n
Bunnies' Garden. (in Bunnies' Car)
You can see Maeve's Bicycle here.

>w
Country Road (in Bunnies' Car)

>sw
Banks of the Calico River (in Bunnies' Car)
You are on the banks of the Calico River, which runs right through the middle of downtown. The Calico River is one of two rivers in Calico Town, the other being Long River.

The river extends to the west from here. To your south is the Hospital and Doctor's Office, and to your east is the Twisty N. Books Airport (TNB).

* * *

>get in
You're not old enough to drive!

>s
Carousel
The carousel is a fun place to hang out, both for the carousel and for the snacks.

To the south is the Playstructure, to the west is the Christmas Theater, and to the north is the Bunnies' Garden.

>s
Playstructure
The Playstructure is fun for all Calicos of all ages, and it was recently renovated.

To the north is the carousel.

>n
Carousel
The carousel is a fun place to hang out, both for the carousel and for the snacks.

To the south is the Playstructure, to the west is the Christmas Theater, and to the north is the Bunnies' Garden.

>w
Christmas Theater
The Christmas Theater has a big stage with lots of colorful lights. At the theater, Calicos are encouraged to sing along with their favorite carols!

To your west is the exit out to the Carousel. To your north is the party area, and to your south is the dance party.

* * *

>w
Bunnies' Garden.
This part of the garden contains the stairs leading up to the entrance, and a tree with lots of birds and flowers. There is also a side gate that leads to the Bunnies' outdoor gear.

To your north, the garden continues, and you can see some vegetables and a pond. To your south is the carousel and the playground.

You can see Bunnies' Car (empty) here.

>n
Bunnies' Garden.
You can see Maeve's Bicycle here.

>get in
You mount Maeve's Bicycle.

>w
Country Road (on Maeve's Bicycle)

>sw
Banks of the Calico River (on Maeve's Bicycle)
You are on the banks of the Calico River, which runs right through the middle of downtown. The Calico River is one of two rivers in Calico Town, the other being Long River.

The river extends to the west from here. To your south is the Hospital and Doctor's Office, and to your east is the Twisty N. Books Airport (TNB).

>ne
Country Road (on Maeve's Bicycle)

>off
That's not a verb I recognise.

>get off
You dismount Maeve's Bicycle.

Country Road
You can see Maeve's Bicycle here.

>get
(Maeve's Bicycle)
That's fixed in place.

>w
You can't go that way.

>s
Christmas Party Area

>n
Country Road
You can see Maeve's Bicycle here.

>w
You can't go that way.

>e
Bunnies' Garden.

>s
Bunnies' Garden.
You can see Bunnies' Car (empty) here.

>get in
You're not old enough to drive!

* * *

>n
Bunnies' Garden.
You can see Maeve's Bicycle here.

>n
Bunnies' Garden.
placeholder. the garden extends to the south and the east from here.

>s
Bunnies' Garden.
placeholder. the garden extends to the north and the south from here.

>w
Country Road

* * *

>n
Bunnies' Garden.
You can see Maeve's Bicycle here.

>s
Bunnies' Garden.
placeholder. the garden extends to the north from here.

* * *

>n
Bunnies' Garden.
You can see Maeve's Bicycle here.

>take pike
You can't see any such thing.

>take bike
That's fixed in place.

>ride bike
You mount Maeve's Bicycle.

>e
You can't go that way.

>w
Country Road (on Maeve's Bicycle)

* * *

>ne
Country Road (on Maeve's Bicycle)

>sw
Banks of the Calico River (on Maeve's Bicycle)
You are on the banks of the Calico River, which runs right through the middle of downtown. The Calico River is one of two rivers in Calico Town, the other being Long River.

The river extends to the west from here. To your south is the Hospital and Doctor's Office, and to your east is the Twisty N. Books Airport (TNB).

>s
Hospital (on Maeve's Bicycle)

>n
Banks of the Calico River (on Maeve's Bicycle)
You are on the banks of the Calico River, which runs right through the middle of downtown. The Calico River is one of two rivers in Calico Town, the other being Long River.

The river extends to the west from here. To your south is the Hospital and Doctor's Office, and to your east is the Twisty N. Books Airport (TNB).

* * *

>n
Bunnies' Garden.
You can see Maeve's Bicycle here.

>w
Country Road
You can see Maeve's Bicycle here.

>get in
You mount Maeve's Bicycle.

>e
Bunnies' Garden. (on Maeve's Bicycle)

>w
Country Road (on Maeve's Bicycle)

* * *

>ne
Country Road (on Maeve's Bicycle)

>get off
You dismount Maeve's Bicycle.

Country Road
You can see Maeve's Bicycle here.

>sw
It's a bit too far to walk from here. Try riding a bike or driving.

>ne
You can't go that way.

>get on
You mount Maeve's Bicycle.

* * *

>w
Country Road
You can see Maeve's Bicycle here.

>get on
You mount Maeve's Bicycle.

>get off
You dismount Maeve's Bicycle.

Country Road
You can see Maeve's Bicycle here.

* * *

>sw
It's a bit too far to walk from here. Try riding a bike or driving.

>get on bike
You mount Maeve's Bicycle.

>sw
Banks of the Calico River (on Maeve's Bicycle)
You are on the banks of the Calico River, which runs right through the middle of downtown. The Calico River is one of two rivers in Calico Town, the other being Long River.

The river extends to the west from here. To your west is riv2

>sw
You can't go that way.

>e
Twisty N. Books Airport (on Maeve's Bicycle)

>w
Banks of the Calico River (on Maeve's Bicycle)
You are on the banks of the Calico River, which runs right through the middle of downtown. The Calico River is one of two rivers in Calico Town, the other being Long River.

The river extends to the west from here. To your west is riv2

>sw
You can't go that way.

>w
Banks of the Calico River (on Maeve's Bicycle)

>get off
You dismount Maeve's Bicycle.

Banks of the Calico River
You can see Maeve's Bicycle here.

>e
It's a bit too far to walk from here. Try riding a bike or driving.

* * *

>w
Country Road
You can see Maeve's Bicycle here.

>s
Christmas Party Area

>s
Christmas Theater

>s
Christmas Dance Party

>s
FunFun Meadow
The FunFun meadow is a beautiful sunny green meadow full of brightly colored flowers. The Long River runs down the middle of FunFun Meadow. The Long River is the longer of the two rivers in Calico Town, the other being Calico River.

The meadow extends to the south from here. To your west is the Calico Public Library, and to the east is FunFun Cafe.

>s
FunFun Meadow
The FunFun meadow is a beautiful sunny green meadow full of brightly colored flowers. The Long River runs down the middle of FunFun Meadow. The Long River is the longer of the two rivers in Calico Town, the other being Calico River.

The meadow extends to the north and the south from here. To your west is the Calico Public Library, and to the east is FunFun Cafe.

>e
FunFun Cafe
placeholder. the cafe extends to the north from here.

>n
FunFun Cafe
placeholder. the cafe extends to the south from here.

>s
FunFun Cafe
placeholder. the cafe extends to the north from here.

>n
FunFun Cafe
placeholder. the cafe extends to the south from here.

* * *

>s
FunFun Cafe
placeholder. the cafe extends to the north from here.

>w
FunFun Meadow
placeholder. the garden extends to nothing from here.

>w
Calico Library
placeholder. the library extends to the north from here.

>n
Calico Library
placeholder. the library extends to the south from here.

>s
Calico Library
placeholder. the library extends to the north from here.

>e
FunFun Meadow
placeholder. the garden extends to nothing from here.

>n
FunFun Meadow
placeholder. the garden extends to nothing from here.

>n
Christmas Dance Party

>n
Christmas Theater

>n
Christmas Party Area

>n
Country Road

>w
You can't go that way.

>sw
Banks of the Calico River

>e
Twisty N. Books Airport

>s
Twisty N. Books Airport

* * *

>s
FunFun Meadow
The FunFun meadow is a beautiful sunny green meadow full of brightly colored flowers. The Long River runs down the middle of FunFun Meadow. The Long River is the longer of the two rivers in Calico Town, the other being Calico River.

The meadow extends to the north and the south from here. To your west is the Calico Public Library, and to the east is FunFun Cafe.

>n
FunFun Meadow

>n
Christmas Dance Party

* * *

>n
Country Road

>sw
Banks of the Calico River
You are on the banks of the Calico River, which runs right through the middle of downtown. The Calico River is one of two rivers in Calico Town, the other being Long River. The river extends to the west from here. To your west is riv2

>e
Twisty N. Books Airport

>e
Calico City Garden

>e
Kangaroos' Living Room

>up
Kangaroos' Bedroom

>d
Kangaroos' Living Room

>w
Calico City Garden

>s
Calico City Garden

>s
Calico Field

>n
Calico City Garden

>se
Sunriver Bowling Alley

>e
Sunriver Bowling Alley

>w
Sunriver Bowling Alley

>m
That's not a verb I recognise.

>n
You can't go that way.

>z
Time passes.

>z
Time passes.

I beg your pardon?

I beg your pardon?

>z
Time passes.

>do nothing
That's not a verb I recognise.

>nothing
That's not a verb I recognise.

>wait
Time passes.

>wait
Time passes.

>look
Sunriver Bowling Alley

>nw
Calico City Garden

>e
Calico Critter Clinic

>w
Calico City Garden

>w
Twisty N. Books Airport

>w
You can't go that way.

>n
Twisty N. Books Airport

>w
Banks of the Calico River
You are on the banks of the Calico River, which runs right through the middle of downtown. The Calico River is one of two rivers in Calico Town, the other being Long River. The river extends to the west from here. To your west is riv2

>w
Banks of the Calico River

>w
Persians' Dining Room

>s
Persians' Bathroom

>n
Persians' Dining Room

>up
Persians' Bedroom

>s
Persians' Living Room

>up
Sandy Cats' Living Room

>n
Sandy Cats' Dining Room

>up
Sandy Cats' Bedroom

>s
Sandy Cats' Balcony

>n
Sandy Cats' Bedroom

>down
Sandy Cats' Dining Room

>s
Sandy Cats' Living Room

>d
Persians' Living Room

>n
Persians' Bedroom

>d
Persians' Dining Room

>w
You can't go that way.

>e
Banks of the Calico River

>n
You can't go that way.

>e
Banks of the Calico River
You are on the banks of the Calico River, which runs right through the middle of downtown. The Calico River is one of two rivers in Calico Town, the other being Long River. The river extends to the west from here. To your west is riv2

>commands
That's not a verb I recognise.

>commands
That's not a verb I recognise.

>command
That's not a verb I recognise.

>help
That's not a verb I recognise.

>help
That's not a verb I recognise.

>purloin
(Banks of the Calico River)
[Can't move Banks of the Calico River: it would contain itself.]

>h
That's not a verb I recognise.

>help
That's not a verb I recognise.

>commands
That's not a verb I recognise.

>actions
Actions listing on.

>help
That's not a verb I recognise.

>actions
Actions listing on.

>w
[going west]

Banks of the Calico River
[going west - succeeded]

>look
[looking]
Banks of the Calico River
[looking - succeeded]

>actions off
Actions listing off.

* * *

>s
FunFun Meadow
The FunFun meadow is a beautiful sunny green meadow full of brightly colored flowers. The Long River runs down the middle of FunFun Meadow. The Long River is the longer of the two rivers in Calico Town, the other being Calico River.

The meadow extends to the north and the south from here. To your west is the Calico Public Library, and to the east is FunFun Cafe.

>s
FunFun Meadow
The FunFun meadow is a beautiful sunny green meadow full of brightly colored flowers. The Long River runs down the middle of FunFun Meadow. The Long River is the longer of the two rivers in Calico Town, the other being Calico River.

The meadow extends to the north and the south from here. To your east is Sundale Calico Grocery Store.

* * *

>w
Country Road
You can see Maeve's Bicycle here.

>sw
Banks of the Calico River
You are on the banks of the Calico River, which runs right through the middle of downtown. The Calico River is one of two rivers in Calico Town, the other being Long River.

The river extends to the west from here.

* * *

>w
Country Road
You can see Maeve's Bicycle here.

>w
You can't go that way.

>on
That's not a verb I recognise.

>get on
You mount Maeve's Bicycle.

>sw
Banks of the Calico River (on Maeve's Bicycle)
You are on the banks of the Calico River, which runs right through the middle of downtown. The Calico River is one of two rivers in Calico Town, the other being Long River.

The river extends to the west from here. To your west is riv2

>offf
That's not a verb I recognise.

>off
That's not a verb I recognise.

>get off
You dismount Maeve's Bicycle.

Banks of the Calico River
You are on the banks of the Calico River, which runs right through the middle of downtown. The Calico River is one of two rivers in Calico Town, the other being Long River.

The river extends to the west from here. To your west is riv2

You can see Maeve's Bicycle here.

* * *

>w
Bunnies' Garden.
This part of the garden contains the stairs leading up to the entrance, and a tree with lots of birds and flowers. There is also a side gate that leads to the Bunnies' outdoor gear.

To your north, the garden continues, and you can see some vegetables and a pond. To your south is the carousel and the playground.

You can see Bunnies' Car (empty) here.

>s
Playground
placeholder. the playground extends to the south from here.

>s
Playground
placeholder. the playground extends to the north from here.

>s
You can't go that way.

>n
Playground
placeholder. the playground extends to the south from here.

>n
Bunnies' Garden.
placeholder. the garden extends to the north from here.

>n
Bunnies' Garden.
placeholder. the garden extends to the north and the south from here.

>w
Country Road

>s
Christmas Party Area

* * *

>s
Christmas Dance Party

>s
FunFun Meadow
placeholder. the garden extends to nothing from here.

* * *

Calico City Mystery
An Interactive Fiction by TurtleCorn Productions
Release 1 / Serial number 220628 / Inform 7 build 6M62 (I6/v6.34 lib 6/12N) SD

Bunnies' Bedroom
The Bunnies' Bedroom has a bunkbed against one wall for you and Liam Bunny, and a bed for each parent. Next to the bunkbed is a desk, and in front of the beds is a wardrobe.

To your south is the living room.

>spin handles
That's not a verb I recognise.

>spin handle
That's not a verb I recognise.

>turn handle
You can't see any such thing.

>look at foosball table
On the foosball game is a small white ball (still).

>look at ball
Currently still.

Joey fails to hit the ball in your direction. It remains still.

>look at handles
Okay, a couple of the tiny men have had their feet broken off, and the table surface itself is a bit warped, and the ball resembles a quail egg in respect of shape and color. This makes for a game of unusual randomness, but skill is overrated.

Joey fails to hit the ball in your direction. It remains still.

>hit ball
Violence isn't the answer to this one.

Joey fails to hit the ball in your direction. It remains still.

>turn handles
You madly rotate the tiny men on sticks! Somehow you fail to bring your monopodal player into contact with the ball.

Joey fails to hit the ball in your direction. It remains still.

>turn handles
You madly rotate the tiny men on sticks! Somehow you fail to bring your monopodal player into contact with the ball.

Joey fails to hit the ball in your direction. It remains still.

>turn handles
You madly rotate the tiny men on sticks! Hoorah! You hit the ball!

Joey tries to block, but misses! Back it goes in the center, where it is still.

[Your score has just gone up by one point.]

>turn handles
You madly rotate the tiny men on sticks! Hoorah! You hit the ball!

Joey connects with your shot. Now the ball is approaching!

>turn handles
Thwack! You keep the ball from reaching its goal! Now it is receding.

Joey connects with your shot. Now the ball is still!

>turn handles
You madly rotate the tiny men on sticks! Somehow you fail to bring your monopodal player into contact with the ball.

Joey hits the ball solidly down towards your goal. Now it is approaching.

>turn handles
Thunk. You keep the ball from reaching its goal! Now it is still.

Joey hits the ball solidly down towards your goal. Now it is approaching.

>turn handles
Thunk. You keep the ball from reaching its goal! Now it is still.

Joey hits the ball solidly down towards your goal. Now it is approaching.

>turn handles
Thwack! You keep the ball from reaching its goal! Now it is receding.

Joey tries to block, but misses! Back it goes in the center, where it is still.

[Your score has just gone up by one point.]

>turn handles
You madly rotate the tiny men on sticks! Hoorah! You hit the ball!

Joey tries to block, but misses! Back it goes in the center, where it is still.

[Your score has just gone up by one point.]

>turn handles
You hit the ball off-center and it rolls sluggishly into a little dip in the surface of the foosball table. You and Joey exchange glances. This is never good.

Joey glares angrily at the stuck ball.

>turn handles
The ball has somehow gotten to a mystical point on the table where it cannot be reached, no matter what. Close inspection reveals that this point has been marked in chalk with a tiny X. Not that that does any good.

Joey glares angrily at the stuck ball.

>shake table
That's not a verb I recognise.

>shove table
That's not a verb I recognise.

>hit table
You give the table a good shove, and the ball moves ever-so-slightly.

Joey fails to hit the ball in your direction. It remains still.

>turn handles
You madly rotate the tiny men on sticks! Hoorah! You hit the ball!

Joey connects with your shot. Now the ball is approaching!

>turn handles
Thwack! You keep the ball from reaching its goal! Now it is receding.

Joey connects with your shot. Now the ball is approaching!

>turn handles
The ball rolls neatly into your goal, despite your efforts. You put the ball back in the center with a snap. No reason to worry yet; you're still ahead. Joey looks determined, though.

Joey hits the ball solidly down towards your goal. Now it is approaching.

>turn handles
Thunk. You keep the ball from reaching its goal! Now it is still.

Joey fails to hit the ball in your direction. It remains still.

>turn handles
You madly rotate the tiny men on sticks! Hoorah! You hit the ball!

Joey connects with your shot. Now the ball is still!

>turn handles
You madly rotate the tiny men on sticks! Hoorah! You hit the ball!

Joey connects with your shot. Now the ball is approaching!

>turn handles
The ball rolls neatly into your goal, despite your efforts. You put the ball back in the center with a snap. No reason to worry yet; you're still ahead. Joey looks determined, though.

Joey fails to hit the ball in your direction. It remains still.

>turn handles
You madly rotate the tiny men on sticks! Somehow you fail to bring your monopodal player into contact with the ball.

Joey hits the ball solidly down towards your goal. Now it is approaching.

>turn handles
Thwack! You keep the ball from reaching its goal! Now it is receding.

Joey tries to block, but misses! Back it goes in the center, where it is still.

[Your score has just gone up by one point.]

* * *

>turn handles
You madly rotate the tiny men on sticks! Hoorah! You hit the ball!

Joey tries to block, but misses! Back it goes in the center, where it is still.

[Your score has just gone up by one point.]

>turn handles
You madly rotate the tiny men on sticks! Hoorah! You hit the ball!

Joey connects with your shot. Now the ball is still!

>turn handles
You madly rotate the tiny men on sticks! Hoorah! You hit the ball!

Joey tries to block, but misses! Back it goes in the center, where it is still.

[Your score has just gone up by one point.]

>turn handles
You madly rotate the tiny men on sticks! Somehow you fail to bring your monopodal player into contact with the ball.

Joey fails to hit the ball in your direction. It remains still.

>turn handles
You madly rotate the tiny men on sticks! Hoorah! You hit the ball!

Joey connects with your shot. Now the ball is still!

>turn handles
You madly rotate the tiny men on sticks! Somehow you fail to bring your monopodal player into contact with the ball.

Joey fails to hit the ball in your direction. It remains still.

>turn handles
You hit the ball off-center and it rolls sluggishly into a little dip in the surface of the foosball table. You and Joey exchange glances. This is never good.

Joey glares angrily at the stuck ball.

>hit table
You give the table a good shove, and the ball moves ever-so-slightly.

Joey hits the ball solidly down towards your goal. Now it is approaching.

>turn handles
Thunk. You keep the ball from reaching its goal! Now it is still.

Joey fails to hit the ball in your direction. It remains still.

>turn handles
You madly rotate the tiny men on sticks! Somehow you fail to bring your monopodal player into contact with the ball.

Joey hits the ball solidly down towards your goal. Now it is approaching.

>turn handles
Thwack! You keep the ball from reaching its goal! Now it is receding.

Joey connects with your shot. Now the ball is approaching!

>turn handles
The ball rolls neatly into your goal, despite your efforts. You put the ball back in the center with a snap. No reason to worry yet; you're still ahead. Joey looks determined, though.

    *** Victory is yours! ***

In that game you scored 7 out of a possible 0, in 41 turns.

Would you like to RESTART, RESTORE a saved game, QUIT or UNDO the last command?

* * *

Calico City Mystery
An Interactive Fiction by TurtleCorn Productions
Release 1 / Serial number 220628 / Inform 7 build 6M62 (I6/v6.34 lib 6/12N) SD

Bunnies' Bedroom
The Bunnies' Bedroom has a bunkbed against one wall for you and Liam Bunny, and a bed for each parent. Next to the bunkbed is a desk, and in front of the beds is a wardrobe.

To your south is the living room.

>x liam's bed
Liam's bed is blue, and you see a stuffed turtle there.

As you examine Liam's Bed, you notice that there is a seam around part of the wall in the shape of a door. You tap on it, and the door swings open!

>x liam's bed
Liam's bed is blue, and you see a stuffed turtle there.

>x wall
The wallpaper is neatly decorated with flowers. A panel in the wall, just big enough to fit through, has been opened to reveal a hidden door to the east.

* * *

Calico City Mystery
An Interactive Fiction by TurtleCorn Productions
Release 1 / Serial number 220628 / Inform 7 build 6M62 (I6/v6.34 lib 6/12N) SD

Bunnies' Bedroom
The Bunnies' Bedroom has a bunkbed against one wall for you and Liam Bunny, and a bed for each parent. Next to the bunkbed is a desk, and in front of the beds is a wardrobe.

To your south is the living room.

>x wallpaper
The wallpaper is neatly decorated with flowers.

As you examine the wallpaper, you notice that there is a seam around part of the wall in the shape of a door. You tap on it, and the door swings open!

>x wallpaper
The wallpaper is neatly decorated with flowers. A panel in the wall, just big enough to fit through, has been opened to reveal a hidden door to the east.

>close door
You close the hidden door.

>x wallpaper
The wallpaper is neatly decorated with flowers. Part of the wall seems to have a seam around it.

>open door
You open the hidden door.

>e
Liam Bunny's Stash
It seems like a place that Liam Bunny has been using for a while to store candy and snacks.