Zork Maze
An Interactive Fiction by liam
Release 1 / Serial number 220723 / Inform 7 build 6M62 (I6/v6.34 lib 6/12N) SD

Troll Room.
This is a simulation of the zork maze, just go west to start the maze.

>w
Maze
This is part of a maze of twisty little passages, all alike.

>s
Maze
This is part of a maze of twisty little passages, all alike.

>ne
Maze
This is part of a maze of twisty little passages, all alike.

>e
Maze
This is part of a maze of twisty little passages, all alike.

>e
Troll Room.
This is a simulation of the zork maze, just go west to start the maze.

>e
You can't go that way.

>w
Maze
This is part of a maze of twisty little passages, all alike.

>w
Maze
This is part of a maze of twisty little passages, all alike.

>w
You can't go that way.

>w
You can't go that way.

>s
You can't go that way.