Calico City
A peek into Calico Life by TurtleCorn Productions
Release 1 / Serial number 220704 / Inform 7 build 6M62 (I6/v6.34 lib 6/12N) SD

Bunnies' Bedroom
The Bunnies' Bedroom has a bunkbed against one wall for you and Liam Bunny, and a bed for each parent. Next to the bunkbed is a desk, and in front of the beds is a wardrobe. 

To your south is the living room.

You can see a Bunkbed here.

>accuse box
That's your best guess? the Box?

>accuse the Box
You can't see any such thing.

* * *

>accuse box
That's your best guess? the Box?

>look dave
You see nothing special about Dave.

* * *

Calico City
A peek into Calico Life by TurtleCorn Productions
Release 1 / Serial number 220704 / Inform 7 build 6M62 (I6/v6.34 lib 6/12N) SD

Bunnies' Bedroom
The Bunnies' Bedroom has a bunkbed against one wall for you and Liam Bunny, and a bed for each parent. Next to the bunkbed is a desk, and in front of the beds is a wardrobe. 

To your south is the living room.

You can see a Bunkbed here.

>buy ice cream
You can't see any such thing.

>eat ice cream
You can't see any such thing.

>look
Bunnies' Bedroom
The Bunnies' Bedroom has a bunkbed against one wall for you and Liam Bunny, and a bed for each parent. Next to the bunkbed is a desk, and in front of the beds is a wardrobe. 

To your south is the living room.

>i
You are carrying:
  a wallet
    *10 in cash.

* * *

>buy ice cream
You can't see any such thing.

>i
You are carrying:
  an ice cream
  a wallet
    $8.34 in cash.

* * *

Calico City
A peek into Calico Life by TurtleCorn Productions
Release 1 / Serial number 220704 / Inform 7 build 6M62 (I6/v6.34 lib 6/12N) SD

Bunnies' Bedroom
The Bunnies' Bedroom has a bunkbed against one wall for you and Liam Bunny, and a bed for each parent. Next to the bunkbed is a desk, and in front of the beds is a wardrobe. 

To your south is the living room.

You can see a Bunkbed here.

>climb
You must supply a noun.

>climb up
You must supply a noun.

>climb living room
You can't see any such thing.

>climb bedroom
You can't see any such thing.

* * *

Calico City
A peek into Calico Life by TurtleCorn Productions
Release 1 / Serial number 220704 / Inform 7 build 6M62 (I6/v6.34 lib 6/12N) SD

Bunnies' Bedroom
The Bunnies' Bedroom has a bunkbed against one wall for you and Liam Bunny, and a bed for each parent. Next to the bunkbed is a desk, and in front of the beds is a wardrobe. 

To your south is the living room.

You can see a Bunkbed here.

>e
You can't go that way.

>up
Bunny House Dining Room

>w
You can't go that way.

>e
Bunny House Bathroom

* * *

>e
You can't go that way.

>w
You can't go that way.

>s
Bunnies' Living Room

>w
Garden1

>look
Garden1

>x bunny farm
You can't see any such thing.

* * *

Calico City
A peek into Calico Life by TurtleCorn Productions
Release 1 / Serial number 220704 / Inform 7 build 6M62 (I6/v6.34 lib 6/12N) SD

Bunnies' Bedroom
The Bunnies' Bedroom has a bunkbed against one wall for you and Liam Bunny, and a bed for each parent. Next to the bunkbed is a desk, and in front of the beds is a wardrobe. 

To your south is the living room.

You can see a Bunkbed here.

>go
You'll have to say which compass direction to go in.

Daddy Bunny arrives from the south.

Bunnies' Bathroom

>z
Time passes.

Daddy Bunny goes south.

Bunnies' Bathroom

>z
Time passes.

Bunnies' Bathroom

>z
Time passes.

Bunnies' Bathroom

>z
Time passes.

You'll have to say which compass direction to go in.
I didn't understand that instruction.
Bunnies' Bathroom

* * *

Calico City
A peek into Calico Life by TurtleCorn Productions
Release 1 / Serial number 220704 / Inform 7 build 6M62 (I6/v6.34 lib 6/12N) SD

Bunnies' Bedroom
The Bunnies' Bedroom has a bunkbed against one wall for you and Liam Bunny, and a bed for each parent. Next to the bunkbed is a desk, and in front of the beds is a wardrobe. 

To your south is the living room.

You can see a Bunkbed here.

>go to sundale calico grocery store
You can't see any such thing.

>s
Bunnies' Living Room
The Bunnies' Living Room has a big couch, with two small couches on either side. There is a small coffee table with the TV as well as some toys and books. 

To your west is the front door and exit, and there are stairs leading up to the dining room and kitchen. To your north is the bedroom.

You can see Daddy Bunny here.

Daddy Bunny goes west.

I beg your pardon?

>n
Bunnies' Bedroom
The Bunnies' Bedroom has a bunkbed against one wall for you and Liam Bunny, and a bed for each parent. Next to the bunkbed is a desk, and in front of the beds is a wardrobe. 

To your south is the living room.

>w
You can't go that way.

>s
Bunnies' Living Room
The Bunnies' Living Room has a big couch, with two small couches on either side. There is a small coffee table with the TV as well as some toys and books. 

To your west is the front door and exit, and there are stairs leading up to the dining room and kitchen. To your north is the bedroom.

>s
You can't go that way.

>s
You can't go that way.

>w
Bunnies' Garden.
This part of the garden contains the stairs leading up to the entrance, and a tree with lots of birds and flowers. There is also a side gate that leads to the Bunnies' outdoor gear.  

To your north, the garden continues, and you can see some vegetables and a pond. To your south is the carousel and the playground.

You can see Bunnies' Car (empty) here.

>n
Bunnies' Garden.
Here you can see Mommy Bunny's vegetable garden, and there are fruits and flowers growing there as well. There is also a cute pond next to the vegetable garden that is a nice place to take a swim.

To your northeast and south the garden continues. To the south is the front door of the house, and to the northeast is the outdoor patio. To your west is the road.

You can see Maeve's Bicycle here.

>w
Country Road
This road leads downtown to the southwest. To your south is the Christmas Party Building, and to your east is the Bunny Family's garden.

>s
Christmas Party Area
In the Christmas Party Area, there is a bunch of Christmas trees and fun activities such as cookie decorating and making ornaments. It is currently a few weeks from Christmas, so the Party Area is feeling very lively. The room is full of holiday food.

To your north is the exit and the road, and to your south is the Christmas Theater.

>s
Christmas Theater
The Christmas Theater has a big stage with lots of colorful lights. At the theater, Calicos are encouraged to sing along with their favorite carols!

To your east is the exit out to the Carousel. To your north is the party area, and to your south is the dance party.

>s
Christmas Dance Party
The Christmas Dance Party has a big disco floor and lights. Lots of Calicos love dancing here, and it gets more popular the closer it is to Christmas. The famous giant Calico Christmas tree is here as well, overlooking the disco floor.

To your north is the theater, and to your south is FunFun Meadow.

>s
FunFun Meadow
The FunFun meadow is a beautiful sunny green meadow full of brightly colored flowers. The Long River runs down the middle of FunFun Meadow. The FunFun Meadow is a great and popular place for picnics. 

The meadow extends to the south from here. To your west is the Calico Public Library, and to the east is FunFun Cafe.

>s
FunFun Meadow
The FunFun meadow is a beautiful sunny green meadow full of brightly colored flowers. The Long River runs down the middle of FunFun Meadow. The FunFun Meadow is a great and popular place for picnics. 

The meadow extends to the north and the south from here. To your west is the Calico Public Library, and to the east is FunFun Cafe.

>ss
That's not a verb I recognise.

>s
FunFun Meadow
The FunFun meadow is a beautiful sunny green meadow full of brightly colored flowers. The Long River runs down the middle of FunFun Meadow. The FunFun Meadow is a great and popular place for picnics. 

The meadow extends to the north and the south from here. To your east is Sundale Calico Grocery Store.

>e
Sundale Calico Grocery Store
The Sundale Calico Grocery Store is named after a famous Calico named Bluebell Sundale who created unique new ways to grow food. Inside is a delicious arrangement of food. Grocer Fox runs the store.

To the west is FunFun Meadow.

>wait 4 hours
Your patience isn't quite good enough to wait that long.

>wait 1 hour
It is now 9:40 am.

>wait 1 hour
It is now 10:40 am.

>wait 1 hour
It is now 11:40 am.

>wait 1 hour
It is now 12:40 pm.

>wait 1 hour
It is now 1:40 pm.

>wait 1 hour
It is now 2:40 pm.

>wait 1 hour
It is now 3:40 pm.

I beg your pardon?

I beg your pardon?

>wait 1 hour
It is now 4:40 pm.

>wait 1 hour
It is now 5:40 pm.

>wait 19 minute
It is now 5:59 pm.

>z
Time passes.

>z
Time passes.

>look
Sundale Calico Grocery Store
The Sundale Calico Grocery Store is named after a famous Calico named Bluebell Sundale who created unique new ways to grow food. Inside is a delicious arrangement of food. Grocer Fox runs the store.

To the west is FunFun Meadow.

You are gently led out of the store, as Sundale Calico Grocery Store is closing right now.

FunFun Meadow
The FunFun meadow is a beautiful sunny green meadow full of brightly colored flowers. The Long River runs down the middle of FunFun Meadow. The FunFun Meadow is a great and popular place for picnics. 

The meadow extends to the north and the south from here. To your east is Sundale Calico Grocery Store.

* * *

Calico City
A peek into Calico Life by TurtleCorn Productions
Release 1 / Serial number 220704 / Inform 7 build 6M62 (I6/v6.34 lib 6/12N) SD

Bunnies' Bedroom
The Bunnies' Bedroom has a bunkbed against one wall for you and Liam Bunny, and a bed for each parent. Next to the bunkbed is a desk, and in front of the beds is a wardrobe. 

To your south is the living room.

You can see a Bunkbed here.

>i
You are carrying:
  a wallet
    *10 in cash.

>buy ice cream
You pay $1.66 and buy the ice cream, leaving you with $8.02.

* * *

Calico City
A peek into Calico Life by TurtleCorn Productions
Release 1 / Serial number 220704 / Inform 7 build 6M62 (I6/v6.34 lib 6/12N) SD

Bunnies' Bedroom
The Bunnies' Bedroom has a bunkbed against one wall for you and Liam Bunny, and a bed for each parent. Next to the bunkbed is a desk, and in front of the beds is a wardrobe. 

To your south is the living room.

You can see a Bunkbed here.

>look at ice cream
You see nothing special about the ice cream.

You can buy it for $1.66.

>buy ice cream
You pay $1.66 and buy the ice cream, leaving you with $8.02.

>buy ice cream
the ice cream is yours.

* * *

Calico City
A peek into Calico Life by TurtleCorn Productions
Release 1 / Serial number 220704 / Inform 7 build 6M62 (I6/v6.34 lib 6/12N) SD

Bunnies' Bedroom
The Bunnies' Bedroom has a bunkbed against one wall for you and Liam Bunny, and a bed for each parent. Next to the bunkbed is a desk, and in front of the beds is a wardrobe. 

To your south is the living room.

You can see a Bunkbed here.

>look at laptop
The laptop looks slightly old and used. Attached to the laptop is a sticky note that says "Password - BunnyBest333".

Mommy's laptop is currently switched off.

>turn on
(Mommy's laptop)
(opening and starting up Mommy's laptop)
Mommy's laptop chimes cheerfully.

A box on the screen invites you to type a password to proceed.

>BunnyBest333
That's not a verb I recognise.

>type BunnyBest333
The password field vanishes.

The following messages are available for you to read or reply to:

9:00 am: Maeve meeting with Angel
9:04 am: Boarding Passes

>read Maeve
No such message is available.

>read maeve meeting with angel
Angel is free today, does Maeve want to meet? We can meet anywhere, but at 4 o'clock we are going sailing, so we should meet before then. Angel wants to meet at FunFun Meadow or the playground. -Mommy Rabbit

>read boarding passes
Attached below are your tickets and boarding passes for flight 322 to Sand Park City. Thank you for flying with Sylvanian Airways. -sylvanianairways.com

* * *

Calico City
A peek into Calico Life by TurtleCorn Productions
Release 1 / Serial number 220704 / Inform 7 build 6M62 (I6/v6.34 lib 6/12N) SD

Bunnies' Bedroom
The Bunnies' Bedroom has a bunkbed against one wall for you and Liam Bunny, and a bed for each parent. Next to the bunkbed is a desk, and in front of the beds is a wardrobe. 

To your south is the living room.

You can see a Bunkbed here.

>look at wallpaper
The wallpaper is neatly decorated with flowers.

* * *

Calico City
A peek into Calico Life by TurtleCorn Productions
Release 1 / Serial number 220704 / Inform 7 build 6M62 (I6/v6.34 lib 6/12N) SD

Bunnies' Bedroom
The Bunnies' Bedroom has a bunkbed against one wall for you and Liam Bunny, and a bed for each parent. Next to the bunkbed is a desk, and in front of the beds is a wardrobe. 

To your south is the living room.

You can see a Bunkbed here.

>look dave
You see nothing special about Dave.

>look liam
You see nothing special about Liam.

>look sylvia
You see nothing special about Sylvia.

>look maeve
You see nothing special about Maeve.

>look marshmallow
they look suspicious.

>accuse marshmallow
That's not a verb I recognise.

>accusing marshmallow
That's not a verb I recognise.

>accus marshmallow
That's not a verb I recognise.

>marshmallow
That's not a verb I recognise.

* * *

Calico City
A peek into Calico Life by TurtleCorn Productions
Release 1 / Serial number 220704 / Inform 7 build 6M62 (I6/v6.34 lib 6/12N) SD

Bunnies' Bedroom
The Bunnies' Bedroom has a bunkbed against one wall for you and Liam Bunny, and a bed for each parent. Next to the bunkbed is a desk, and in front of the beds is a wardrobe. 

To your south is the living room.

You can see a Bunkbed here.

>look laptop
The small laptop is currently switched off.

Bunnies' Garden.

>turn on
(the small laptop)
(opening and starting up the small laptop)
The small laptop chimes cheerfully.

A box on the screen invites you to type a password to proceed.

Bunnies' Garden.

>type bunnybest333
"Password incorrect."

Country Road

>type BunnyBest333
The password field vanishes.

The following messages are available for you to read or reply to:

9:00 am: meet at FunFun Meadow near the grocery store
9:04 am: SPAM

Banks of the Calico River

* * *

Calico City
A peek into Calico Life by TurtleCorn Productions
Release 1 / Serial number 220704 / Inform 7 build 6M62 (I6/v6.34 lib 6/12N) SD

Bunnies' Bedroom
The Bunnies' Bedroom has a bunkbed against one wall for you and Liam Bunny, and a bed for each parent. Next to the bunkbed is a desk, and in front of the beds is a wardrobe. 

To your south is the living room.

You can see a Bunkbed here.

>look liam
they don't look suspicious.

>look dave
they don't look suspicious.

>is dave the thief
That's not a verb I recognise.

>accuse dave
That's not a verb I recognise.

* * *

>look dave
they don't look suspicious.

>look sylvia
they don't look suspicious.

>accuse sylvia
Sylvia says "oh, you caught me".

* * *

>look sylvia
they don't look suspicious.

>look maeve
they don't look suspicious.

>look box
You see nothing special about Box.

>look marshmallow
they look suspicious.

>accuse marshmallow
Marshmallow says "oh, you caught me".

* * *

Calico City
A peek into Calico Life by TurtleCorn Productions
Release 1 / Serial number 220704 / Inform 7 build 6M62 (I6/v6.34 lib 6/12N) SD

Bunnies' Bedroom
The Bunnies' Bedroom has a bunkbed against one wall for you and Liam Bunny, and a bed for each parent. Next to the bunkbed is a desk, and in front of the beds is a wardrobe. 

To your south is the living room.

You can see a Bunkbed here.

>look region
You can't see any such thing.

>region
That's not a verb I recognise.

>look
Bunny House Bedroom

* * *

Calico City
A peek into Calico Life by TurtleCorn Productions
Release 1 / Serial number 220704 / Inform 7 build 6M62 (I6/v6.34 lib 6/12N) SD

Bunnies' Bedroom
The Bunnies' Bedroom has a bunkbed against one wall for you and Liam Bunny, and a bed for each parent. Next to the bunkbed is a desk, and in front of the beds is a wardrobe. 

To your south is the living room.

You can see a Bunkbed here.

>n
You can't go that way.

>s
You can't go that way.

>w
You can't go that way.

>e
You can't go that way.

>talk
That's not a verb I recognise.

>hi
That's not a verb I recognise.

>no
That was a rhetorical question.

>what
That's not a verb I recognise.

* * *

Calico City
A peek into Calico Life by TurtleCorn Productions
Release 1 / Serial number 220704 / Inform 7 build 6M62 (I6/v6.34 lib 6/12N) SD

Bunnies' Bedroom
The Bunnies' Bedroom has a bunkbed against one wall for you and Liam Bunny, and a bed for each parent. Next to the bunkbed is a desk, and in front of the beds is a wardrobe. 

To your south is the living room.

You can see a Bunkbed here.

>open laptop
You open Mommy's laptop.

>turn on
(Mommy's laptop)
Mommy's laptop chimes cheerfully.

A box on the screen invites you to type a password to proceed.

>type BunnyBest333
The password field vanishes.

The following messages are available for you to read or reply to:

9:00 am: Maeve Meeting With Angel
9:04 am: Boarding Passes
9:07 am: Fourth of July
9:08 am: Fourth of July Sale

>read Maeve Meeting With Angel
Angel is free today, does Maeve want to meet? We can meet anywhere, but at 4 o'clock we are going sailing, so we should meet before then. Angel wants to meet at FunFun Meadow or the playground. -Mommy Rabbit

>read Boarding Passes
Attached below are your tickets and boarding passes for flight 322 to Sand Park City. Thank you for flying with Sylvanian Airways. -sylvanianairways.com

>read Fourth of July
For the Fourth of July celebration, I think we should all meet at FunFun Meadow. If anyone has a reason that they can't go, please RSVP so I know. The Bunnies will bring the hot dogs and burgers, the Rabbits will bring the buns and condiments, the Persians will bring the fireworks, the Cats will bring dessert, the ponies will bring salad and we will bring tables and chairs. -Mommy Kangaroo

>read Fourth of July Sale
Today, go to the Sundale Calico Grocery store for a special Fourth of July sale!!! Get 50% off all purchases today! -sundalegrocerystore.com

>reply to fourth of july
I feel like replying to your mom's emails is a bad idea.

>answer fourth of july
(to yourself)
There is no reply.

* * *

Calico City
A peek into Calico Life by TurtleCorn Productions
Release 1 / Serial number 220704 / Inform 7 build 6M62 (I6/v6.34 lib 6/12N) SD

Bunnies' Bedroom
The Bunnies' Bedroom has a bunkbed against one wall for you and Liam Bunny, and a bed for each parent. Next to the bunkbed is a desk, and in front of the beds is a wardrobe. 

To your south is the living room.

You can see a Bunkbed here.

>s
Bunnies' Living Room
The Bunnies' Living Room has a big couch, with two small couches on either side. There is a small coffee table with the TV as well as some toys and books. 

To your west is the front door and exit, and there are stairs leading up to the dining room and kitchen. To your north is the bedroom.

You can see Daddy Bunny here.

Daddy Bunny goes west.

* * *

I beg your pardon?

>w
Bunnies' Garden.
This part of the garden contains the stairs leading up to the entrance, and a tree with lots of birds and flowers. There is also a side gate that leads to the Bunnies' outdoor gear.  

To your north, the garden continues, and you can see some vegetables and a pond. To your south is the carousel and the playground.

You can see Daddy Bunny and Bunnies' Car (empty) here.

Daddy Bunny goes north.

>w
You can't go that way.

>s
Carousel
The carousel is a fun place to hang out, both for the carousel and for the snacks.

To the south is the Playstructure, to the west is the Christmas Theater, and to the north is the Bunnies' Garden.

>w
Christmas Theater
The Christmas Theater has a big stage with lots of colorful lights. At the theater, Calicos are encouraged to sing along with their favorite carols!

To your east is the exit out to the Carousel. To your north is the party area, and to your south is the dance party.

>s
Christmas Dance Party
The Christmas Dance Party has a big disco floor and lights. Lots of Calicos love dancing here, and it gets more popular the closer it is to Christmas. The famous giant Calico Christmas tree is here as well, overlooking the disco floor.

To your north is the theater, and to your south is FunFun Meadow.

* * *

>s
FunFun Meadow
The FunFun meadow is a beautiful sunny green meadow full of brightly colored flowers. The Long River runs down the middle of FunFun Meadow. The FunFun Meadow is a great and popular place for picnics. 

The meadow extends to the north and the south from here. To your west is the Calico Public Library, and to the east is FunFun Cafe.

>e
FunFun Cafe
This area of the FunFun Cafe is the seating area where Calicos eat their delicious meals. On the wall is a picture of the original FunFun cafe. The cafe extends to the north from here. To your west is FunFun Meadow.

>wait 30 minutes
It is now 9:01 am.

>wait one hour
It is now 10:01 am.

>wait one hour
It is now 11:01 am.

>wait one hour
It is now 12:01 pm.

>wait one hour
It is now 1:01 pm.

>wait one hour
It is now 2:01 pm.

>wait one hour
It is now 3:01 pm.

>wait one hour
It is now 4:01 pm.

>wait one hour
It is now 5:01 pm.

>wait 58 minutes
It is now 5:59 pm.

>z
Time passes.

>s
You can't go that way.

>w
FunFun Meadow
The FunFun meadow is a beautiful sunny green meadow full of brightly colored flowers. The Long River runs down the middle of FunFun Meadow. The FunFun Meadow is a great and popular place for picnics. 

The meadow extends to the north and the south from here. To your west is the Calico Public Library, and to the east is FunFun Cafe.

>e
FunFun Cafe
This area of the FunFun Cafe is the seating area where Calicos eat their delicious meals. On the wall is a picture of the original FunFun cafe. The cafe extends to the north from here. To your west is FunFun Meadow.

>w
FunFun Meadow
The FunFun meadow is a beautiful sunny green meadow full of brightly colored flowers. The Long River runs down the middle of FunFun Meadow. The FunFun Meadow is a great and popular place for picnics. 

The meadow extends to the north and the south from here. To your west is the Calico Public Library, and to the east is FunFun Cafe.

* * *

>s
Bunnies' Living Room
The Bunnies' Living Room has a big couch, with two small couches on either side. There is a small coffee table with the TV as well as some toys and books. 

To your west is the front door and exit, and there are stairs leading up to the dining room and kitchen. To your north is the bedroom.

You can see Daddy Bunny here.

Daddy Bunny goes west.

>look
Bunnies' Living Room

>w
Playground
placeholder. the playground extends to the south from here.

>n
Playground
placeholder. the playground extends to nothing from here.

>e
You can't go that way.

* * *

>s
Bunnies' Living Room
The Bunnies' Living Room has a big couch, with two small couches on either side. There is a small coffee table with the TV as well as some toys and books. 

To your west is the front door and exit, and there are stairs leading up to the dining room and kitchen. To your north is the bedroom.

You can see Daddy Bunny here.

Daddy Bunny goes west.

>talk
That's not a verb I recognise.

>x daddy bunny
(Daddy Bunny) Hi Maeve! How are you? I'm just going to the bowling alley for a little bit.

>z
Time passes.

Daddy Bunny mops the floor.

Daddy Bunny goes west.

>z
Time passes.

I beg your pardon?

>z
Time passes.

2

>z
Time passes.

3

>z
Time passes.

4

>z
Time passes.

5

>z
Time passes.

6

>z
Time passes.

7

>z
Time passes.

8

>z
Time passes.

1

>z
Time passes.

>z
Time passes.

Daddy Bunny arrives from the west.

>x daddy bunny
(Daddy Bunny) Hi Maeve! How are you? I'm just going to clean the bathroom.

* * *

>s
Bunnies' Living Room
The Bunnies' Living Room has a big couch, with two small couches on either side. There is a small coffee table with the TV as well as some toys and books. 

To your west is the front door and exit, and there are stairs leading up to the dining room and kitchen. To your north is the bedroom.

You can see Daddy Bunny here.

Daddy Bunny goes west.

>talk to daddy bunny
You can't see any such thing.

>wait 30 seconds
I only understood you as far as wanting to wait.

* * *

>s
Bunnies' Living Room
The Bunnies' Living Room has a big couch, with two small couches on either side. There is a small coffee table with the TV as well as some toys and books. 

To your west is the front door and exit, and there are stairs leading up to the dining room and kitchen. To your north is the bedroom.

You can see Daddy Bunny here.

Daddy Bunny goes west.

>up
Bunnies' Dining Room
The dining room table and chairs are wooden, and painted red. On the wall is a broom to help clean up the big messes that Liam Bunny makes. Along the wall is the kitchen.

To your south is the bathroom, and there are stairs leading down to the living room.

>s
Bunnies' Bathroom
The bathroom has all the normal things in a bathroom. On the wall is a laundry machine and a vacuum cleaner. In the bathtub is a toy bath turtle.

To the north is the kitchen and dining room.

>n
Bunnies' Dining Room
The dining room table and chairs are wooden, and painted red. On the wall is a broom to help clean up the big messes that Liam Bunny makes. Along the wall is the kitchen.

To your south is the bathroom, and there are stairs leading down to the living room.

>d
Bunnies' Living Room

>w
Bunnies' Garden.
placeholder. the playground extends to the south from here.

>s
Playground

* * *

>n
Bunnies' Dining Room
The dining room table and chairs are wooden, and painted red. On the wall is a broom to help clean up the big messes that Liam Bunny makes. Along the wall is the kitchen.

To your south is the bathroom, and there are stairs leading down to the living room.

>dow
That's not a verb I recognise.

>d
Bunnies' Living Room
The Bunnies' Living Room has a big couch, with two small couches on either side. There is a small coffee table with the TV as well as some toys and books.

To your west is the front door and exit, and there are stairs leading up to the dining room and kitchen. To your north is the bedroom.

>w
Bunnies' Garden.
This part of the garden contains the stairs leading up to the entrance, and a tree with lots of birds and flowers. There is also a side gate that leads to the Bunnies' outdoor gear.

To your north, the garden continues, and you can see some vegetables and a pond. to your south is the carousel and the playground.

You can see Bunnies' Car (empty) here.

* * *

>s
Bunnies' Bathroom
The bathroom has all the normal things in a bathroom. On the wall is a laundry machine and a vacuum cleaner. In the bathtub is a toy bath turtle.

To the north is the kitchen and dining room.

>take turtle
You can't see any such thing.

>n
Bunnies' Dining Room
The dining room table and chairs are wooden, and painted red. On the wall is a broom to help clean up the big messes that Liam Bunny makes. Along the wall is the kitchen.

To your south is the bathroom, and there are stairs leading down to the living room.

>down
Bunnies' Living Room
The Bunnies' Living Room has a big couch, with two small couches on either side. There is a small coffee table with the TV as well as some toys and books.

To your west is the front door and exit, and there are stairs leading up to the dining room and kitchen. To your north is the bedroom.

>w
Bunnies' Garden.
This part of the garden contains the stairs leading up to the entrance, and a tree with lots of birds and flowers. There is also a side gate that leads to the Bunnies' outdoor gear.

To your north, the garden continues, and you can see some vegetables and a pond. To your south is the carousel and the playground.

You can see Bunnies' Car (empty) here.

>drive car
That's not a verb I recognise.

>get in car
You're not old enough to drive!

>s
Carousel
The carousel is a fun place to hang out, both for the carousel and for the snacks.

To the south is the Playstructure, to the west is the Christmas Theater, and to the north is the Bunnies' Garden.

>on
That's not a verb I recognise.

>ride carousel
You can't see any such thing.

>west
Christmas Theater
The Christmas Theater has a big stage with lots of colorful lights. At the theater, Calicos are encouraged to sing along with their favorite carols!

To your east is the exit out to the Carousel. To your north is the party area, and to your south is the dance party.

>n
Christmas Party Area
In the Christmas Party Area, there is a bunch of Christmas trees and fun activities such as cookie decorating and making ornaments. It is currently a few weeks from Christmas, so the Party Area is feeling very lively. The room is full of holiday food.

To your north is the exit and the road, and to your south is the Christmas Theater.

>eat cookies
You can't see any such thing.

>n
Country Road
This road leads downtown to the southwest. To your south is the Christmas Party Building, and to your east is the Bunny Family's garden.

>e
Bunnies' Garden.
Here you can see Mommy Bunny's vegetable garden, and there are fruits and flowers growing there as well. There is also a cute pond next to the vegetable garden that is a nice place to take a swim.

To your northeast and south the garden continues. To the south is the front door of the house, and to the northeast is the outdoor patio. To your west is the road.

You can see Maeve's Bicycle here.

>ride bike
You mount Maeve's Bicycle.

>w
Country Road (on Maeve's Bicycle)
This road leads downtown to the southwest. To your south is the Christmas Party Building, and to your east is the Bunny Family's garden.

>i
You are carrying nothing.

>do wheelie
That's not a verb I recognise.

>get off
You dismount Maeve's Bicycle.

Country Road
This road leads downtown to the southwest. To your south is the Christmas Party Building, and to your east is the Bunny Family's garden.

You can see Maeve's Bicycle here.

>sw
It's a bit too far to walk from here. Try riding a bike or driving.

>get on
You mount Maeve's Bicycle.

>sw
Banks of the Calico River (on Maeve's Bicycle)
You are on the banks of the Calico River, which runs right through the middle of downtown. The Calico River is one of two rivers in Calico Town, the other being Long River.

The river extends to the west from here. To your south is the Hospital and Doctor's Office, and to your east is the Twisty N. Books Airport (TNB).

>get off
You dismount Maeve's Bicycle.

Banks of the Calico River
You are on the banks of the Calico River, which runs right through the middle of downtown. The Calico River is one of two rivers in Calico Town, the other being Long River.

The river extends to the west from here. To your south is the Hospital and Doctor's Office, and to your east is the Twisty N. Books Airport (TNB).

You can see Maeve's Bicycle here.

>ne
It's a bit too far to walk from here. Try riding a bike or driving.

>get on
You mount Maeve's Bicycle.

>ne
Country Road (on Maeve's Bicycle)
This road leads downtown to the southwest. To your south is the Christmas Party Building, and to your east is the Bunny Family's garden.

>sw
Banks of the Calico River (on Maeve's Bicycle)
You are on the banks of the Calico River, which runs right through the middle of downtown. The Calico River is one of two rivers in Calico Town, the other being Long River.

The river extends to the west from here. To your south is the Hospital and Doctor's Office, and to your east is the Twisty N. Books Airport (TNB).

* * *

>get off
You dismount Maeve's Bicycle.

Banks of the Calico River
You are on the banks of the Calico River, which runs right through the middle of downtown. The Calico River is one of two rivers in Calico Town, the other being Long River.

The river extends to the west from here. To your south is the Hospital and Doctor's Office, and to your east is the Twisty N. Books Airport (TNB).

You can see Maeve's Bicycle here.

>e
Twisty N. Books Airport

>n
You can't go that way.

>n
You can't go that way.

>w
Banks of the Calico River
You are on the banks of the Calico River, which runs right through the middle of downtown. The Calico River is one of two rivers in Calico Town, the other being Long River.

The river extends to the west from here. To your south is the Hospital and Doctor's Office, and to your east is the Twisty N. Books Airport (TNB).

You can see Maeve's Bicycle here.

* * *

>s
Bunnies' Living Room
The Bunnies' Living Room has a big couch, with two small couches on either side. There is a small coffee table with the TV as well as some toys and books. 

To your west is the front door and exit, and there are stairs leading up to the dining room and kitchen. To your north is the bedroom.

You can see Daddy Bunny here.

Daddy Bunny goes west.

>w
Bunnies' Garden.
This part of the garden contains the stairs leading up to the entrance, and a tree with lots of birds and flowers. There is also a side gate that leads to the Bunnies' outdoor gear.  

To your north, the garden continues, and you can see some vegetables and a pond. To your south is the carousel and the playground.

You can see Daddy Bunny and Bunnies' Car (empty) here.

Daddy Bunny goes north.

>get in
You're not old enough to drive!

>n
Bunnies' Garden. (in Bunnies' Car)
You can see Maeve's Bicycle here.

>w
Country Road (in Bunnies' Car)

>sw
Banks of the Calico River (in Bunnies' Car)
You are on the banks of the Calico River, which runs right through the middle of downtown. The Calico River is one of two rivers in Calico Town, the other being Long River.

The river extends to the west from here. To your south is the Hospital and Doctor's Office, and to your east is the Twisty N. Books Airport (TNB).

* * *

>get in
You're not old enough to drive!

>s
Carousel
The carousel is a fun place to hang out, both for the carousel and for the snacks.

To the south is the Playstructure, to the west is the Christmas Theater, and to the north is the Bunnies' Garden.

>s
Playstructure
The Playstructure is fun for all Calicos of all ages, and it was recently renovated.

To the north is the carousel.

>n
Carousel
The carousel is a fun place to hang out, both for the carousel and for the snacks.

To the south is the Playstructure, to the west is the Christmas Theater, and to the north is the Bunnies' Garden.

>w
Christmas Theater
The Christmas Theater has a big stage with lots of colorful lights. At the theater, Calicos are encouraged to sing along with their favorite carols!

To your west is the exit out to the Carousel. To your north is the party area, and to your south is the dance party.

* * *

>w
Bunnies' Garden.
This part of the garden contains the stairs leading up to the entrance, and a tree with lots of birds and flowers. There is also a side gate that leads to the Bunnies' outdoor gear.  

To your north, the garden continues, and you can see some vegetables and a pond. To your south is the carousel and the playground.

You can see Daddy Bunny and Bunnies' Car (empty) here.

Daddy Bunny goes north.

>n
Bunnies' Garden.
Here you can see Mommy Bunny's vegetable garden, and there are fruits and flowers growing there as well. There is also a cute pond next to the vegetable garden that is a nice place to take a swim.

To your northeast and south the garden continues. To the south is the front door of the house, and to the northeast is the outdoor patio. To your west is the road.

You can see Daddy Bunny and Maeve's Bicycle here.

Daddy Bunny goes west.

>get in
You mount Maeve's Bicycle.

>w
Country Road (on Maeve's Bicycle)

>sw
Banks of the Calico River (on Maeve's Bicycle)
You are on the banks of the Calico River, which runs right through the middle of downtown. The Calico River is one of two rivers in Calico Town, the other being Long River.

The river extends to the west from here. To your south is the Hospital and Doctor's Office, and to your east is the Twisty N. Books Airport (TNB).

>ne
Country Road (on Maeve's Bicycle)

>off
That's not a verb I recognise.

>get off
You dismount Maeve's Bicycle.

Country Road
You can see Maeve's Bicycle here.

>get
(Maeve's Bicycle)
That's fixed in place.

>w
You can't go that way.

>s
Christmas Party Area

>n
Country Road
You can see Maeve's Bicycle here.

>w
You can't go that way.

>e
Bunnies' Garden.

>s
Bunnies' Garden.
You can see Bunnies' Car (empty) here.

>get in
You're not old enough to drive!

* * *

>n
Bunnies' Garden.
Here you can see Mommy Bunny's vegetable garden, and there are fruits and flowers growing there as well. There is also a cute pond next to the vegetable garden that is a nice place to take a swim.

To your northeast and south the garden continues. To the south is the front door of the house, and to the northeast is the outdoor patio. To your west is the road.

You can see Daddy Bunny and Maeve's Bicycle here.

Daddy Bunny goes west.

>n
Bunnies' Garden.
placeholder. the garden extends to the south and the east from here.

>s
Bunnies' Garden.
placeholder. the garden extends to the north and the south from here.

>w
Country Road

* * *

>n
Bunnies' Garden.
Here you can see Mommy Bunny's vegetable garden, and there are fruits and flowers growing there as well. There is also a cute pond next to the vegetable garden that is a nice place to take a swim.

To your northeast and south the garden continues. To the south is the front door of the house, and to the northeast is the outdoor patio. To your west is the road.

You can see Daddy Bunny and Maeve's Bicycle here.

Daddy Bunny goes west.

>s
Bunnies' Garden.
placeholder. the garden extends to the north from here.

* * *

>n
Bunnies' Garden.
Here you can see Mommy Bunny's vegetable garden, and there are fruits and flowers growing there as well. There is also a cute pond next to the vegetable garden that is a nice place to take a swim.

To your northeast and south the garden continues. To the south is the front door of the house, and to the northeast is the outdoor patio. To your west is the road.

You can see Daddy Bunny and Maeve's Bicycle here.

Daddy Bunny goes west.

>take pike
You can't see any such thing.

>take bike
That's fixed in place.

>ride bike
You mount Maeve's Bicycle.

>e
You can't go that way.

>w
Country Road (on Maeve's Bicycle)

* * *

>ne
Country Road (on Maeve's Bicycle)

>sw
Banks of the Calico River (on Maeve's Bicycle)
You are on the banks of the Calico River, which runs right through the middle of downtown. The Calico River is one of two rivers in Calico Town, the other being Long River.

The river extends to the west from here. To your south is the Hospital and Doctor's Office, and to your east is the Twisty N. Books Airport (TNB).

>s
Hospital (on Maeve's Bicycle)

>n
Banks of the Calico River (on Maeve's Bicycle)
You are on the banks of the Calico River, which runs right through the middle of downtown. The Calico River is one of two rivers in Calico Town, the other being Long River.

The river extends to the west from here. To your south is the Hospital and Doctor's Office, and to your east is the Twisty N. Books Airport (TNB).

* * *

>n
Bunnies' Garden.
Here you can see Mommy Bunny's vegetable garden, and there are fruits and flowers growing there as well. There is also a cute pond next to the vegetable garden that is a nice place to take a swim.

To your northeast and south the garden continues. To the south is the front door of the house, and to the northeast is the outdoor patio. To your west is the road.

You can see Daddy Bunny and Maeve's Bicycle here.

Daddy Bunny goes west.

>w
Country Road
This road leads downtown to the southwest. To your south is the Christmas Party Building, and to your east is the Bunny Family's garden.

You can see Daddy Bunny here.

Daddy Bunny goes southwest.

>get in
You mount Maeve's Bicycle.

>e
Bunnies' Garden. (on Maeve's Bicycle)

>w
Country Road (on Maeve's Bicycle)

* * *

>ne
Country Road (on Maeve's Bicycle)

>get off
You dismount Maeve's Bicycle.

Country Road
You can see Maeve's Bicycle here.

>sw
It's a bit too far to walk from here. Try riding a bike or driving.

>ne
You can't go that way.

>get on
You mount Maeve's Bicycle.

* * *

>w
Country Road
This road leads downtown to the southwest. To your south is the Christmas Party Building, and to your east is the Bunny Family's garden.

You can see Daddy Bunny here.

Daddy Bunny goes southwest.

>get on
You mount Maeve's Bicycle.

>get off
You dismount Maeve's Bicycle.

Country Road
You can see Maeve's Bicycle here.

* * *

>sw
It's a bit too far to walk from here. Try riding a bike or driving.

>get on bike
You mount Maeve's Bicycle.

>sw
Banks of the Calico River (on Maeve's Bicycle)
You are on the banks of the Calico River, which runs right through the middle of downtown. The Calico River is one of two rivers in Calico Town, the other being Long River.

The river extends to the west from here. To your west is riv2

>sw
You can't go that way.

>e
Twisty N. Books Airport (on Maeve's Bicycle)

>w
Banks of the Calico River (on Maeve's Bicycle)
You are on the banks of the Calico River, which runs right through the middle of downtown. The Calico River is one of two rivers in Calico Town, the other being Long River.

The river extends to the west from here. To your west is riv2

>sw
You can't go that way.

>w
Banks of the Calico River (on Maeve's Bicycle)

>get off
You dismount Maeve's Bicycle.

Banks of the Calico River
You can see Maeve's Bicycle here.

>e
It's a bit too far to walk from here. Try riding a bike or driving.

* * *

>w
Country Road
This road leads downtown to the southwest. To your south is the Christmas Party Building, and to your east is the Bunny Family's garden.

You can see Daddy Bunny here.

Daddy Bunny goes southwest.

>s
Christmas Party Area
In the Christmas Party Area, there is a bunch of Christmas trees and fun activities such as cookie decorating and making ornaments. It is currently a few weeks from Christmas, so the Party Area is feeling very lively. The room is full of holiday food.

To your north is the exit and the road, and to your south is the Christmas Theater.

* * *

>s
FunFun Meadow
The FunFun meadow is a beautiful sunny green meadow full of brightly colored flowers. The Long River runs down the middle of FunFun Meadow. The FunFun Meadow is a great and popular place for picnics. 

The meadow extends to the south from here. To your west is the Calico Public Library, and to the east is FunFun Cafe.

>e
FunFun Cafe
In front of you, there is the counter where you can order, and behind it is the kitchen full of delicious food and great smells. The cafe extends to the south from here. To your west is FunFun Meadow.

You can see Mommy Bunny here.

 Mommy Bunny mixes some ingredients in a bowl.

>z
Time passes.

 Mommy Bunny puts something on a grill.

>z
Time passes.

 Mommy Bunny mixes some ingredients in a bowl.

>z
Time passes.

 (Mommy Bunny) Hi Maeve!

>z
Time passes.

 Mommy Bunny puts something on a grill.

>z
Time passes.

 Mommy Bunny takes something off the grill.

>z
Time passes.

 Mommy Bunny mixes some ingredients in a bowl.

* * *

>s
FunFun Meadow
The FunFun meadow is a beautiful sunny green meadow full of brightly colored flowers. The Long River runs down the middle of FunFun Meadow. The FunFun Meadow is a great and popular place for picnics. 

The meadow extends to the north and the south from here. To your west is the Calico Public Library, and to the east is FunFun Cafe.

>e
FunFun Cafe
placeholder. the cafe extends to the north from here.

>n
FunFun Cafe
placeholder. the cafe extends to the south from here.

>s
FunFun Cafe
placeholder. the cafe extends to the north from here.

>n
FunFun Cafe
placeholder. the cafe extends to the south from here.

* * *

>s
FunFun Cafe
placeholder. the cafe extends to the north from here.

>w
FunFun Meadow
placeholder. the garden extends to nothing from here.

>w
Calico Library
placeholder. the library extends to the north from here.

>n
Calico Library
placeholder. the library extends to the south from here.

>s
Calico Library
placeholder. the library extends to the north from here.

>e
FunFun Meadow
placeholder. the garden extends to nothing from here.

>n
FunFun Meadow
placeholder. the garden extends to nothing from here.

>n
Christmas Dance Party

>n
Christmas Theater

>n
Christmas Party Area

>n
Country Road

>w
You can't go that way.

>sw
Banks of the Calico River

>e
Twisty N. Books Airport

>s
Twisty N. Books Airport

* * *

>s
FunFun Meadow
The FunFun meadow is a beautiful sunny green meadow full of brightly colored flowers. The Long River runs down the middle of FunFun Meadow. The FunFun Meadow is a great and popular place for picnics. 

The meadow extends to the north and the south from here. To your west is the Calico Public Library, and to the east is FunFun Cafe.

>n
FunFun Meadow

>n
Christmas Dance Party

* * *

>n
Country Road

>sw
Banks of the Calico River
You are on the banks of the Calico River, which runs right through the middle of downtown. The Calico River is one of two rivers in Calico Town, the other being Long River. The river extends to the west from here. To your west is riv2

>e
Twisty N. Books Airport

>e
Calico City Garden

>e
Kangaroos' Living Room

>up
Kangaroos' Bedroom

>d
Kangaroos' Living Room

>w
Calico City Garden

>s
Calico City Garden

>s
Calico Field

>n
Calico City Garden

>se
Sunriver Bowling Alley

>e
Sunriver Bowling Alley

>w
Sunriver Bowling Alley

>m
That's not a verb I recognise.

>n
You can't go that way.

>z
Time passes.

* * *

I beg your pardon?

>z
Time passes.

>do nothing
That's not a verb I recognise.

>nothing
That's not a verb I recognise.

>wait
Time passes.

>wait
Time passes.

>look
Sunriver Bowling Alley

>nw
Calico City Garden

>e
Calico Critter Clinic

>w
Calico City Garden

>w
Twisty N. Books Airport

>w
You can't go that way.

>n
Twisty N. Books Airport

>w
Banks of the Calico River
You are on the banks of the Calico River, which runs right through the middle of downtown. The Calico River is one of two rivers in Calico Town, the other being Long River. The river extends to the west from here. To your west is riv2

>w
Banks of the Calico River

>w
Persians' Dining Room

>s
Persians' Bathroom

>n
Persians' Dining Room

>up
Persians' Bedroom

>s
Persians' Living Room

>up
Sandy Cats' Living Room

>n
Sandy Cats' Dining Room

>up
Sandy Cats' Bedroom

>s
Sandy Cats' Balcony

>n
Sandy Cats' Bedroom

>down
Sandy Cats' Dining Room

>s
Sandy Cats' Living Room

>d
Persians' Living Room

>n
Persians' Bedroom

>d
Persians' Dining Room

>w
You can't go that way.

>e
Banks of the Calico River

>n
You can't go that way.

>e
Banks of the Calico River
You are on the banks of the Calico River, which runs right through the middle of downtown. The Calico River is one of two rivers in Calico Town, the other being Long River. The river extends to the west from here. To your west is riv2

>commands
That's not a verb I recognise.

>commands
That's not a verb I recognise.

>command
That's not a verb I recognise.

>help
That's not a verb I recognise.

>help
That's not a verb I recognise.

>purloin
(Banks of the Calico River)
[Can't move Banks of the Calico River: it would contain itself.]

>h
That's not a verb I recognise.

>help
That's not a verb I recognise.

>commands
That's not a verb I recognise.

>actions
Actions listing on.

>help
That's not a verb I recognise.

>actions
Actions listing on.

>w
[going west]

Banks of the Calico River
[going west - succeeded]

>look
[looking]
Banks of the Calico River
[looking - succeeded]

>actions off
Actions listing off.

* * *

>s
FunFun Meadow
The FunFun meadow is a beautiful sunny green meadow full of brightly colored flowers. The Long River runs down the middle of FunFun Meadow. The FunFun Meadow is a great and popular place for picnics. 

The meadow extends to the north and the south from here. To your west is the Calico Public Library, and to the east is FunFun Cafe.

>s
FunFun Meadow
The FunFun meadow is a beautiful sunny green meadow full of brightly colored flowers. The Long River runs down the middle of FunFun Meadow. The FunFun Meadow is a great and popular place for picnics. 

The meadow extends to the north and the south from here. To your east is Sundale Calico Grocery Store.

>wait 1 hr
I only understood you as far as wanting to wait.

>wait 1 hour
It is now 9:32 am.

>wait 1 hour
It is now 10:32 am.

>wait 1 hour
It is now 11:32 am.

>wait 1 hour
It is now 12:32 pm.

>e
Sundale Calico Grocery Store
The Sundale Calico Grocery Store is named after a famous Calico named Bluebell Sundale who created unique new ways to grow food. Inside is a delicious arrangement of food. Grocer Fox runs the store.

To the west is FunFun Meadow.

>wait 1 hour
It is now 1:33 pm.

>wait 1 hour
It is now 2:33 pm.

>wait 1 hour
It is now 3:33 pm.

>wait 1 hour
It is now 4:33 pm.

>wait 1 hour
It is now 5:33 pm.

>wait 1 hour
It is now 6:33 pm.

You are gently led out of the store, as Sundale Calico Grocery Store is closing right now.

FunFun Meadow
The FunFun meadow is a beautiful sunny green meadow full of brightly colored flowers. The Long River runs down the middle of FunFun Meadow. The FunFun Meadow is a great and popular place for picnics. 

The meadow extends to the north and the south from here. To your east is Sundale Calico Grocery Store.

>e
Sundale Calico Grocery Store has been closed since 6:00 pm and won't be open until tomorrow at 8:00 am.

>slep
That's not a verb I recognise.

>sleep
What would you sleep on?

>n
FunFun Meadow
The FunFun meadow is a beautiful sunny green meadow full of brightly colored flowers. The Long River runs down the middle of FunFun Meadow. The FunFun Meadow is a great and popular place for picnics. 

The meadow extends to the north and the south from here. To your west is the Calico Public Library, and to the east is FunFun Cafe.

>n
FunFun Meadow
The FunFun meadow is a beautiful sunny green meadow full of brightly colored flowers. The Long River runs down the middle of FunFun Meadow. The FunFun Meadow is a great and popular place for picnics. 

The meadow extends to the south from here. To your west is the Calico Public Library, and to the east is FunFun Cafe.

>n
Christmas Dance Party
The Christmas Dance Party has a big disco floor and lights. Lots of Calicos love dancing here, and it gets more popular the closer it is to Christmas. The famous giant Calico Christmas tree is here as well, overlooking the disco floor.

To your north is the theater, and to your south is FunFun Meadow.

>n
Christmas Theater
The Christmas Theater has a big stage with lots of colorful lights. At the theater, Calicos are encouraged to sing along with their favorite carols!

To your east is the exit out to the Carousel. To your north is the party area, and to your south is the dance party.

>n
Christmas Party Area
In the Christmas Party Area, there is a bunch of Christmas trees and fun activities such as cookie decorating and making ornaments. It is currently a few weeks from Christmas, so the Party Area is feeling very lively. The room is full of holiday food.

To your north is the exit and the road, and to your south is the Christmas Theater.

Daddy Bunny arrives from the north.

>n
Country Road
This road leads downtown to the southwest. To your south is the Christmas Party Building, and to your east is the Bunny Family's garden.

* * *

>e
Bunnies' Garden.
Here you can see Mommy Bunny's vegetable garden, and there are fruits and flowers growing there as well. There is also a cute pond next to the vegetable garden that is a nice place to take a swim.

To your northeast and south the garden continues. To the south is the front door of the house, and to the northeast is the outdoor patio. To your west is the road.

You can see Maeve's Bicycle here.

>s
Bunnies' Garden.
This part of the garden contains the stairs leading up to the entrance, and a tree with lots of birds and flowers. There is also a side gate that leads to the Bunnies' outdoor gear.  

To your north, the garden continues, and you can see some vegetables and a pond. To your south is the carousel and the playground.

You can see Bunnies' Car (empty) here.

>w
You can't go that way.

>e
Bunnies' Living Room
The Bunnies' Living Room has a big couch, with two small couches on either side. There is a small coffee table with the TV as well as some toys and books. 

To your west is the front door and exit, and there are stairs leading up to the dining room and kitchen. To your north is the bedroom.

>n
Bunnies' Bedroom
The Bunnies' Bedroom has a bunkbed against one wall for you and Liam Bunny, and a bed for each parent. Next to the bunkbed is a desk, and in front of the beds is a wardrobe. 

To your south is the living room.

You can see a Bunkbed here.

>sleep
d 3:00 am 6:46 pm

>sleep
d 3:00 am 6:47 pm

>z
Time passes.

>sleep
d 3:00 am 7:00 pm

>sleep
d 3:00 am 7:01 pm

* * *

>s
FunFun Meadow
The FunFun meadow is a beautiful sunny green meadow full of brightly colored flowers. The Long River runs down the middle of FunFun Meadow. The FunFun Meadow is a great and popular place for picnics. 

The meadow extends to the north and the south from here. To your east is Sundale Calico Grocery Store.

>wait one hr
I only understood you as far as wanting to wait.

>wait one hour
It is now 9:32 am.

>wait one hour
It is now 10:32 am.

>wait one hour
It is now 11:32 am.

I beg your pardon?

>wait one hour
It is now 12:32 pm.

>wait one hour
It is now 1:32 pm.

>wait one hour
It is now 2:32 pm.

>wait one hour
It is now 3:32 pm.

>wait one hour
It is now 4:32 pm.

>wait one hour
It is now 5:32 pm.

>wait one hour
It is now 6:32 pm.

>e
Sundale Calico Grocery Store has been closed since 6:00 pm and won't be open until tomorrow at 8:00 am.

>wait ten hours
Your patience isn't quite good enough to wait that long.

It is now 4:33 am.

>wait ten hours
Your patience isn't quite good enough to wait that long.

It is now 2:33 pm.

>wait three hours
Your patience isn't quite good enough to wait that long.

It is now 5:33 pm.

>wait 24 minutes
It is now 5:57 pm.

>e
Sundale Calico Grocery Store
The Sundale Calico Grocery Store is named after a famous Calico named Bluebell Sundale who created unique new ways to grow food. Inside is a delicious arrangement of food. Grocer Fox runs the store.

To the west is FunFun Meadow.

FunFun Meadow
The FunFun meadow is a beautiful sunny green meadow full of brightly colored flowers. The Long River runs down the middle of FunFun Meadow. The FunFun Meadow is a great and popular place for picnics. 

The meadow extends to the north and the south from here. To your east is Sundale Calico Grocery Store.

>z
Time passes.

>e
Sundale Calico Grocery Store has been closed since 6:00 pm and won't be open until tomorrow at 8:00 am.

>wait 23 hours
Your patience isn't quite good enough to wait that long.

It is now 5:04 pm.

Daddy Bunny arrives from the north.

>wait 55 minutes
It is now 5:59 pm.

Daddy Bunny goes east.

>z
Time passes.

>wait 23 hours
Your patience isn't quite good enough to wait that long.

It is now 5:01 pm.

>wait 55 minutes
It is now 5:56 pm.

>e
Sundale Calico Grocery Store
The Sundale Calico Grocery Store is named after a famous Calico named Bluebell Sundale who created unique new ways to grow food. Inside is a delicious arrangement of food. Grocer Fox runs the store.

To the west is FunFun Meadow.

You can see Daddy Bunny here.

FunFun Meadow
The FunFun meadow is a beautiful sunny green meadow full of brightly colored flowers. The Long River runs down the middle of FunFun Meadow. The FunFun Meadow is a great and popular place for picnics. 

The meadow extends to the north and the south from here. To your east is Sundale Calico Grocery Store.

Daddy Bunny arrives from the east.

>e
Sundale Calico Grocery Store
The Sundale Calico Grocery Store is named after a famous Calico named Bluebell Sundale who created unique new ways to grow food. Inside is a delicious arrangement of food. Grocer Fox runs the store.

To the west is FunFun Meadow.

FunFun Meadow
The FunFun meadow is a beautiful sunny green meadow full of brightly colored flowers. The Long River runs down the middle of FunFun Meadow. The FunFun Meadow is a great and popular place for picnics. 

The meadow extends to the north and the south from here. To your east is Sundale Calico Grocery Store.

You can see Daddy Bunny here.

Daddy Bunny goes north.

>e
Sundale Calico Grocery Store
The Sundale Calico Grocery Store is named after a famous Calico named Bluebell Sundale who created unique new ways to grow food. Inside is a delicious arrangement of food. Grocer Fox runs the store.

To the west is FunFun Meadow.

FunFun Meadow
The FunFun meadow is a beautiful sunny green meadow full of brightly colored flowers. The Long River runs down the middle of FunFun Meadow. The FunFun Meadow is a great and popular place for picnics. 

The meadow extends to the north and the south from here. To your east is Sundale Calico Grocery Store.

>e
Sundale Calico Grocery Store
The Sundale Calico Grocery Store is named after a famous Calico named Bluebell Sundale who created unique new ways to grow food. Inside is a delicious arrangement of food. Grocer Fox runs the store.

To the west is FunFun Meadow.

FunFun Meadow
The FunFun meadow is a beautiful sunny green meadow full of brightly colored flowers. The Long River runs down the middle of FunFun Meadow. The FunFun Meadow is a great and popular place for picnics. 

The meadow extends to the north and the south from here. To your east is Sundale Calico Grocery Store.

>e
Sundale Calico Grocery Store has been closed since 6:00 pm and won't be open until tomorrow at 8:00 am.

* * *

>w
Country Road
This road leads downtown to the southwest. To your south is the Christmas Party Building, and to your east is the Bunny Family's garden.

You can see Daddy Bunny here.

Daddy Bunny goes southwest.

>sw
Banks of the Calico River
You are on the banks of the Calico River, which runs right through the middle of downtown. The Calico River is one of two rivers in Calico Town, the other being Long River.

The river extends to the west from here.

* * *

>w
Country Road
This road leads downtown to the southwest. To your south is the Christmas Party Building, and to your east is the Bunny Family's garden.

You can see Daddy Bunny here.

Daddy Bunny goes southwest.

>w
You can't go that way.

>on
That's not a verb I recognise.

>get on
You mount Maeve's Bicycle.

>sw
Banks of the Calico River (on Maeve's Bicycle)
You are on the banks of the Calico River, which runs right through the middle of downtown. The Calico River is one of two rivers in Calico Town, the other being Long River.

The river extends to the west from here. To your west is riv2

>offf
That's not a verb I recognise.

>off
That's not a verb I recognise.

>get off
You dismount Maeve's Bicycle.

Banks of the Calico River
You are on the banks of the Calico River, which runs right through the middle of downtown. The Calico River is one of two rivers in Calico Town, the other being Long River.

The river extends to the west from here. To your west is riv2

You can see Maeve's Bicycle here.

* * *

>w
Bunnies' Garden.
This part of the garden contains the stairs leading up to the entrance, and a tree with lots of birds and flowers. There is also a side gate that leads to the Bunnies' outdoor gear.  

To your north, the garden continues, and you can see some vegetables and a pond. To your south is the carousel and the playground.

You can see Daddy Bunny and Bunnies' Car (empty) here.

Daddy Bunny goes north.

>s
Carousel
The carousel is a fun place to hang out, both for the carousel and for the snacks.

To the south is the Playstructure, to the west is the Christmas Theater, and to the north is the Bunnies' Garden.

>s
Playground
placeholder. the playground extends to the north from here.

>s
You can't go that way.

>n
Playground
placeholder. the playground extends to the south from here.

>n
Bunnies' Garden.
placeholder. the garden extends to the north from here.

>n
Bunnies' Garden.
placeholder. the garden extends to the north and the south from here.

>w
Country Road

>s
Christmas Party Area

>s
Christmas Theater

>s
Christmas Dance Party

>s
FunFun Meadow
placeholder. the garden extends to nothing from here.

* * *

>s
FunFun Meadow
The FunFun meadow is a beautiful sunny green meadow full of brightly colored flowers. The Long River runs down the middle of FunFun Meadow. The FunFun Meadow is a great and popular place for picnics. 

The meadow extends to the north and the south from here. To your east is Sundale Calico Grocery Store.

>s
FunFun Meadow
The FunFun meadow is a beautiful sunny green meadow full of brightly colored flowers. The Long River runs down the middle of FunFun Meadow. The FunFun Meadow is a great and popular place for picnics. 

The meadow extends to the north from here. To your east is Shell Tinkle Clothing Store. To your south is the dock, and southeast is the beach.

>s
Dock
it s a dock.

>e
Beach
it s a becah

>ne
You can't go that way.

>nw
FunFun Meadow
The FunFun meadow is a beautiful sunny green meadow full of brightly colored flowers. The Long River runs down the middle of FunFun Meadow. The FunFun Meadow is a great and popular place for picnics. 

The meadow extends to the north from here. To your east is Shell Tinkle Clothing Store. To your south is the dock, and southeast is the beach.

* * *

>s
Bunnies' Living Room
The Bunnies' Living Room has a big couch, with two small couches on either side. There is a small coffee table with the TV as well as some toys and books. 

To your west is the front door and exit, and there are stairs leading up to the dining room and kitchen. To your north is the bedroom.

You can see Daddy Bunny here.

Daddy Bunny goes west.

>wait one hour
It is now 9:01 am.

>wait one hour
It is now 10:01 am.

>wait one hour
Daddy Bunny arrives from the west.

Daddy Bunny goes west.

It is now 11:01 am.

>wait one hour
It is now 12:01 pm.

* * *

>wait one hour
It is now 1:01 pm.

>wait one hour
Daddy Bunny arrives from the west.

Daddy Bunny goes west.

It is now 2:01 pm.

>wait one hour
It is now 3:01 pm.

* * *

>wait one hour
It is now 4:01 pm.

>wait one hour
Daddy Bunny arrives from the west.

Daddy Bunny goes west.

It is now 5:01 pm.

>wait 55 minutes
It is now 5:56 pm.

>w
Bunnies' Garden.
This part of the garden contains the stairs leading up to the entrance, and a tree with lots of birds and flowers. There is also a side gate that leads to the Bunnies' outdoor gear.  

To your north, the garden continues, and you can see some vegetables and a pond. To your south is the carousel and the playground.

You can see Bunnies' Car (empty) here.

>z
Time passes.

>wait 22 minutes
Daddy Bunny arrives from the north.

Daddy Bunny goes east.

It is now 6:58 pm.

>z
Time passes.

>look
Bunnies' Garden.
This part of the garden contains the stairs leading up to the entrance, and a tree with lots of birds and flowers. There is also a side gate that leads to the Bunnies' outdoor gear.  

To your north, the garden continues, and you can see some vegetables and a pond. To your south is the carousel and the playground.

You can see Bunnies' Car (empty) here.

>z
Time passes.

>wait 10 minutes
It is now 7:48 pm.

>wait 10 minutes
It is now 7:58 pm.

>wait 10 minutes
It is now 8:08 pm.

>wait 10 minutes
It is now 8:18 pm.

>wait 10 minutes
It is now 8:28 pm.

>wait 10 minutes
It is now 8:38 pm.

I beg your pardon?

>e
Bunnies' Living Room
The Bunnies' Living Room has a big couch, with two small couches on either side. There is a small coffee table with the TV as well as some toys and books. 

To your west is the front door and exit, and there are stairs leading up to the dining room and kitchen. To your north is the bedroom.

>n
Bunnies' Bedroom
The Bunnies' Bedroom has a bunkbed against one wall for you and Liam Bunny, and a bed for each parent. Next to the bunkbed is a desk, and in front of the beds is a wardrobe. 

To your south is the living room.

You can see Daddy Bunny and a Bunkbed here.

>sleep
You get into bed and drift off, and when you wake up, it is 7:54 am.

* * *

>s
Bunnies' Living Room
The Bunnies' Living Room has a big couch, with two small couches on either side. There is a small coffee table with the TV as well as some toys and books. 

To your west is the front door and exit, and there are stairs leading up to the dining room and kitchen. To your north is the bedroom.

You can see Daddy Bunny here.

Daddy Bunny goes west.

>z
Time passes.

>e
You can't go that way.

Daddy Bunny arrives from the west.

>look at daddy bunny
(Daddy Bunny) ??? he gives u monee

>i
You are carrying:
  a wallet
    *14 in cash.

>look at daddy bunny
(Daddy Bunny) ??? he gives u monee

>look at daddy bunny
(Daddy Bunny) ??? he gives u monee

>i
You are carrying:
  a wallet
    *50 in cash.

Daddy Bunny goes west.

>w
Bunnies' Garden.
This part of the garden contains the stairs leading up to the entrance, and a tree with lots of birds and flowers. There is also a side gate that leads to the Bunnies' outdoor gear.  

To your north, the garden continues, and you can see some vegetables and a pond. To your south is the carousel and the playground.

You can see Daddy Bunny and Bunnies' Car (empty) here.

Daddy Bunny goes north.

* * *

>w
Country Road
This road leads downtown to the southwest. To your south is the Christmas Party Building, and to your east is the Bunny Family's garden.

You can see Daddy Bunny here.

Daddy Bunny goes southwest.

>sw
It's a bit too far to walk from here. Try riding a bike or driving.

* * *

Calico City
A peek into Calico Life by TurtleCorn Productions
Release 1 / Serial number 220704 / Inform 7 build 6M62 (I6/v6.34 lib 6/12N) SD

Bunnies' Bedroom
The Bunnies' Bedroom has a bunkbed against one wall for you and Liam Bunny, and a bed for each parent. Next to the bunkbed is a desk, and in front of the beds is a wardrobe. 

To your south is the living room.

You can see a Bunkbed here.

>sleep
d

>bunkbed
That's not a verb I recognise.

* * *

>sleep
d

>wait one hour
It is now 9:23 am.

>wait one hour
It is now 10:23 am.

>wait one hour
It is now 11:23 am.

>wait one hour
It is now 12:23 pm.

>wait one hour
It is now 1:23 pm.

>sleep
d

>wait one hour
It is now 2:24 pm.

>wait one hour
It is now 3:24 pm.

>wait one hour
It is now 4:24 pm.

>wait one hour
It is now 5:24 pm.

>wait one hour
It is now 6:24 pm.

>wait one hour
It is now 7:24 pm.

>sleep
lated

* * *

Calico City
A peek into Calico Life by TurtleCorn Productions
Release 1 / Serial number 220704 / Inform 7 build 6M62 (I6/v6.34 lib 6/12N) SD

Bunnies' Bedroom
The Bunnies' Bedroom has a bunkbed against one wall for you and Liam Bunny, and a bed for each parent. Next to the bunkbed is a desk, and in front of the beds is a wardrobe. 

To your south is the living room.

You can see a Bunkbed here.

>spin handles
That's not a verb I recognise.

>spin handle
That's not a verb I recognise.

>turn handle
You can't see any such thing.

>look at foosball table
On the foosball game is a small white ball (still).

>look at ball
Currently still.

Joey fails to hit the ball in your direction. It remains still.

>look at handles
Okay, a couple of the tiny men have had their feet broken off, and the table surface itself is a bit warped, and the ball resembles a quail egg in respect of shape and color. This makes for a game of unusual randomness, but skill is overrated.

Joey fails to hit the ball in your direction. It remains still.

>hit ball
Violence isn't the answer to this one.

Joey fails to hit the ball in your direction. It remains still.

>turn handles
You madly rotate the tiny men on sticks! Somehow you fail to bring your monopodal player into contact with the ball.

Joey fails to hit the ball in your direction. It remains still.

>turn handles
You madly rotate the tiny men on sticks! Somehow you fail to bring your monopodal player into contact with the ball.

Joey fails to hit the ball in your direction. It remains still.

>turn handles
You madly rotate the tiny men on sticks! Hoorah! You hit the ball!

Joey tries to block, but misses! Back it goes in the center, where it is still.

[Your score has just gone up by one point.]

>turn handles
You madly rotate the tiny men on sticks! Hoorah! You hit the ball!

Joey connects with your shot. Now the ball is approaching!

>turn handles
Thwack! You keep the ball from reaching its goal! Now it is receding.

Joey connects with your shot. Now the ball is still!

>turn handles
You madly rotate the tiny men on sticks! Somehow you fail to bring your monopodal player into contact with the ball.

Joey hits the ball solidly down towards your goal. Now it is approaching.

>turn handles
Thunk. You keep the ball from reaching its goal! Now it is still.

Joey hits the ball solidly down towards your goal. Now it is approaching.

>turn handles
Thunk. You keep the ball from reaching its goal! Now it is still.

Joey hits the ball solidly down towards your goal. Now it is approaching.

>turn handles
Thwack! You keep the ball from reaching its goal! Now it is receding.

Joey tries to block, but misses! Back it goes in the center, where it is still.

[Your score has just gone up by one point.]

>turn handles
You madly rotate the tiny men on sticks! Hoorah! You hit the ball!

Joey tries to block, but misses! Back it goes in the center, where it is still.

[Your score has just gone up by one point.]

>turn handles
You hit the ball off-center and it rolls sluggishly into a little dip in the surface of the foosball table. You and Joey exchange glances. This is never good.

Joey glares angrily at the stuck ball.

>turn handles
The ball has somehow gotten to a mystical point on the table where it cannot be reached, no matter what. Close inspection reveals that this point has been marked in chalk with a tiny X. Not that that does any good.

Joey glares angrily at the stuck ball.

>shake table
That's not a verb I recognise.

>shove table
That's not a verb I recognise.

>hit table
You give the table a good shove, and the ball moves ever-so-slightly.

Joey fails to hit the ball in your direction. It remains still.

>turn handles
You madly rotate the tiny men on sticks! Hoorah! You hit the ball!

Joey connects with your shot. Now the ball is approaching!

>turn handles
Thwack! You keep the ball from reaching its goal! Now it is receding.

Joey connects with your shot. Now the ball is approaching!

>turn handles
The ball rolls neatly into your goal, despite your efforts. You put the ball back in the center with a snap. No reason to worry yet; you're still ahead. Joey looks determined, though.

Joey hits the ball solidly down towards your goal. Now it is approaching.

>turn handles
Thunk. You keep the ball from reaching its goal! Now it is still.

Joey fails to hit the ball in your direction. It remains still.

>turn handles
You madly rotate the tiny men on sticks! Hoorah! You hit the ball!

Joey connects with your shot. Now the ball is still!

>turn handles
You madly rotate the tiny men on sticks! Hoorah! You hit the ball!

Joey connects with your shot. Now the ball is approaching!

>turn handles
The ball rolls neatly into your goal, despite your efforts. You put the ball back in the center with a snap. No reason to worry yet; you're still ahead. Joey looks determined, though.

Joey fails to hit the ball in your direction. It remains still.

>turn handles
You madly rotate the tiny men on sticks! Somehow you fail to bring your monopodal player into contact with the ball.

Joey hits the ball solidly down towards your goal. Now it is approaching.

>turn handles
Thwack! You keep the ball from reaching its goal! Now it is receding.

Joey tries to block, but misses! Back it goes in the center, where it is still.

[Your score has just gone up by one point.]

* * *

>turn handles
You madly rotate the tiny men on sticks! Hoorah! You hit the ball!

Joey tries to block, but misses! Back it goes in the center, where it is still.

[Your score has just gone up by one point.]

>turn handles
You madly rotate the tiny men on sticks! Hoorah! You hit the ball!

Joey connects with your shot. Now the ball is still!

>turn handles
You madly rotate the tiny men on sticks! Hoorah! You hit the ball!

Joey tries to block, but misses! Back it goes in the center, where it is still.

[Your score has just gone up by one point.]

>turn handles
You madly rotate the tiny men on sticks! Somehow you fail to bring your monopodal player into contact with the ball.

Joey fails to hit the ball in your direction. It remains still.

>turn handles
You madly rotate the tiny men on sticks! Hoorah! You hit the ball!

Joey connects with your shot. Now the ball is still!

>turn handles
You madly rotate the tiny men on sticks! Somehow you fail to bring your monopodal player into contact with the ball.

Joey fails to hit the ball in your direction. It remains still.

>turn handles
You hit the ball off-center and it rolls sluggishly into a little dip in the surface of the foosball table. You and Joey exchange glances. This is never good.

Joey glares angrily at the stuck ball.

>hit table
You give the table a good shove, and the ball moves ever-so-slightly.

Joey hits the ball solidly down towards your goal. Now it is approaching.

>turn handles
Thunk. You keep the ball from reaching its goal! Now it is still.

Joey fails to hit the ball in your direction. It remains still.

>turn handles
You madly rotate the tiny men on sticks! Somehow you fail to bring your monopodal player into contact with the ball.

Joey hits the ball solidly down towards your goal. Now it is approaching.

>turn handles
Thwack! You keep the ball from reaching its goal! Now it is receding.

Joey connects with your shot. Now the ball is approaching!

>turn handles
The ball rolls neatly into your goal, despite your efforts. You put the ball back in the center with a snap. No reason to worry yet; you're still ahead. Joey looks determined, though.

    *** Victory is yours! ***

In that game you scored 7 out of a possible 0, in 41 turns.

Would you like to RESTART, RESTORE a saved game, QUIT or UNDO the last command?

* * *

Calico City
A peek into Calico Life by TurtleCorn Productions
Release 1 / Serial number 220704 / Inform 7 build 6M62 (I6/v6.34 lib 6/12N) SD

Bunnies' Bedroom
The Bunnies' Bedroom has a bunkbed against one wall for you and Liam Bunny, and a bed for each parent. Next to the bunkbed is a desk, and in front of the beds is a wardrobe. 

To your south is the living room.

You can see a Bunkbed here.

>wait
Time passes.

Daddy Bunny arrives from the south.

>s
Bunnies' Living Room
The Bunnies' Living Room has a big couch, with two small couches on either side. There is a small coffee table with the TV as well as some toys and books.

To your west is the front door and exit, and there are stairs leading up to the dining room and kitchen. To your north is the bedroom.

Daddy Bunny arrives from the north.

>up
Bunnies' Dining Room
The dining room table and chairs are wooden, and painted red. On the wall is a broom to help clean up the big messes that Liam Bunny makes. Along the wall is the kitchen.

To your south is the bathroom, and there are stairs leading down to the living room.

Daddy Bunny arrives from below.

>s
Bunnies' Bathroom
The bathroom has all the normal things in a bathroom. On the wall is a laundry machine. In the bathtub is a toy bath turtle.

To the north is the kitchen and dining room.

Daddy Bunny arrives from the north.

>n
Bunnies' Dining Room
The dining room table and chairs are wooden, and painted red. On the wall is a broom to help clean up the big messes that Liam Bunny makes. Along the wall is the kitchen.

To your south is the bathroom, and there are stairs leading down to the living room.

You'll have to say which compass direction to go in.
I didn't understand that instruction.

>north
You can't go that way.

You'll have to say which compass direction to go in.
I didn't understand that instruction.

* * *

Calico City
A peek into Calico Life by TurtleCorn Productions
Release 1 / Serial number 220704 / Inform 7 build 6M62 (I6/v6.34 lib 6/12N) SD

Bunnies' Bedroom
The Bunnies' Bedroom has a bunkbed against one wall for you and Liam Bunny, and a bed for each parent. Next to the bunkbed is a desk, and in front of the beds is a wardrobe. 

To your south is the living room.

You can see a Bunkbed here.

>wait 30 minutes
It is now 8:52 am.

>wait one hour
It is now 9:52 am.

>wait one houre
I only understood you as far as wanting to wait.

>wait one hour
It is now 10:52 am.

>s
Bunnies' Living Room
The Bunnies' Living Room has a big couch, with two small couches on either side. There is a small coffee table with the TV as well as some toys and books. 

To your west is the front door and exit, and there are stairs leading up to the dining room and kitchen. To your north is the bedroom.

>e
You can't go that way.

>w
Bunnies' Garden.
This part of the garden contains the stairs leading up to the entrance, and a tree with lots of birds and flowers. There is also a side gate that leads to the Bunnies' outdoor gear.  

To your north, the garden continues, and you can see some vegetables and a pond. To your south is the carousel and the playground.

You can see Bunnies' Car (empty) here.

>s
Carousel
The carousel is a fun place to hang out, both for the carousel and for the snacks.

To the south is the Playstructure, to the west is the Christmas Theater, and to the north is the Bunnies' Garden.

* * *

>s
Playstructure
The Playstructure is fun for all Calicos of all ages, and it was recently renovated.

To the north is the carousel.

>s
You can't go that way.

>n
Carousel
The carousel is a fun place to hang out, both for the carousel and for the snacks.

To the south is the Playstructure, to the west is the Christmas Theater, and to the north is the Bunnies' Garden.

>w
Christmas Theater
The Christmas Theater has a big stage with lots of colorful lights. At the theater, Calicos are encouraged to sing along with their favorite carols!

To your east is the exit out to the Carousel. To your north is the party area, and to your south is the dance party.

* * *

>e
FunFun Cafe
In front of you, there is the counter where you can order, and behind it is the kitchen full of delicious food and great smells. The cafe extends to the south from here. To your west is FunFun Meadow.

You can see Mommy Bunny here.

 Mommy Bunny mixes some ingredients in a bowl.

>wait one hour
 Mommy Bunny puts something on a grill. 
 Mommy Bunny takes something off the grill. 
 Mommy Bunny puts something on a grill. 
 Mommy Bunny takes something off the grill. 
 Mommy Bunny mixes some ingredients in a bowl.

 Mommy Bunny puts something on a grill. 
 Mommy Bunny mixes some ingredients in a bowl.

 Mommy Bunny puts something on a grill. 
 (Mommy Bunny) Hi Maeve! 
 Mommy Bunny takes something off the grill. 
 Mommy Bunny mixes some ingredients in a bowl.

 (Mommy Bunny) Hi Maeve! 
 Mommy Bunny takes something off the grill. 
 Mommy Bunny puts something on a grill. 
 Mommy Bunny mixes some ingredients in a bowl.

 Mommy Bunny puts something on a grill. 
 Mommy Bunny mixes some ingredients in a bowl.

 (Mommy Bunny) Hi Maeve! 
 Mommy Bunny mixes some ingredients in a bowl.

 Mommy Bunny takes something off the grill. 
 Mommy Bunny puts something on a grill. 
 Mommy Bunny takes something off the grill. 
 Mommy Bunny mixes some ingredients in a bowl.

 Mommy Bunny puts something on a grill. 
 Mommy Bunny mixes some ingredients in a bowl.

 Mommy Bunny takes something off the grill. 
 Mommy Bunny mixes some ingredients in a bowl.

 Mommy Bunny puts something on a grill. 
 (Mommy Bunny) Hi Maeve! 
 Mommy Bunny takes something off the grill. 
 Mommy Bunny puts something on a grill. 
 Mommy Bunny takes something off the grill. 
 Mommy Bunny puts something on a grill. 
 (Mommy Bunny) Hi Maeve! 
 Mommy Bunny puts something on a grill. 
 Mommy Bunny mixes some ingredients in a bowl.

 Mommy Bunny takes something off the grill. 
 Mommy Bunny mixes some ingredients in a bowl.

 (Mommy Bunny) Hi Maeve! 
 Mommy Bunny mixes some ingredients in a bowl.

 (Mommy Bunny) Hi Maeve! 
 Mommy Bunny takes something off the grill. 
 Mommy Bunny puts something on a grill. 
 (Mommy Bunny) Hi Maeve! 
 Mommy Bunny takes something off the grill. 
 (Mommy Bunny) Hi Maeve! 
 Mommy Bunny mixes some ingredients in a bowl.

 (Mommy Bunny) Hi Maeve! 
 Mommy Bunny mixes some ingredients in a bowl.

 Mommy Bunny puts something on a grill. 
 (Mommy Bunny) Hi Maeve! 
 Mommy Bunny puts something on a grill. 
 (Mommy Bunny) Hi Maeve! 
 Mommy Bunny takes something off the grill. 
 (Mommy Bunny) Hi Maeve! 
 Mommy Bunny takes something off the grill. 
 (Mommy Bunny) Hi Maeve! 
 Mommy Bunny takes something off the grill. 
 Mommy Bunny mixes some ingredients in a bowl.

It is now 12:03 pm.

 (Mommy Bunny) Hi Maeve!

* * *

Calico City
A peek into Calico Life by TurtleCorn Productions
Release 1 / Serial number 220704 / Inform 7 build 6M62 (I6/v6.34 lib 6/12N) SD

Bunnies' Bedroom
The Bunnies' Bedroom has a bunkbed against one wall for you and Liam Bunny, and a bed for each parent. Next to the bunkbed is a desk, and in front of the beds is a wardrobe. 

To your south is the living room.

You can see a Bunkbed here.

>wait one hour
It is now 9:00 am.

>wait one hour
It is now 10:00 am.

>wait one hour
It is now 11:00 am.

I beg your pardon?

>wait one hour
It is now 12:00 pm.

>wait one hour
It is now 1:00 pm.

>wait one hour
It is now 2:00 pm.

>wait one hour
It is now 3:00 pm.

>wait one hour
It is now 4:00 pm.

>wait one hour
It is now 5:00 pm.

>wait one hour
It is now 6:00 pm.

>wait one hour
da
Daddy Bunny arrives from the south.

da
da
da
da
da
da
da
da
da
da
da
da
da
da
da
da
da
da
It is now 7:00 pm.

da

>sleep
Sorry, but now's not the time for sleeping.

da

>sleep
You get into bed and drift off, and when you wake up, it is 7:45 am.

>look
Bunnies' Bedroom
The Bunnies' Bedroom has a bunkbed against one wall for you and Liam Bunny, and a bed for each parent. Next to the bunkbed is a desk, and in front of the beds is a wardrobe. 

To your south is the living room.

You can see Daddy Bunny and a Bunkbed here.

>wait 13 minutes
It is now 7:59 am.

>z
Time passes.

>z
Time passes.

Daddy Bunny goes south.

* * *

>wait one hour
It is now 11:00 am.

>wait one hour
It is now 12:00 pm.

* * *

>wait one hour
da
Daddy Bunny arrives from the south.

da
da
da
da
da
da
da
da
da
da
da
da
da
da
da
da
da
da
It is now 7:00 pm.

da

>sleep
d 3:00 am 7:00 pm
da

* * *

Calico City
A peek into Calico Life by TurtleCorn Productions
Release 1 / Serial number 220704 / Inform 7 build 6M62 (I6/v6.34 lib 6/12N) SD

Bunnies' Bedroom
The Bunnies' Bedroom has a bunkbed against one wall for you and Liam Bunny, and a bed for each parent. Next to the bunkbed is a desk, and in front of the beds is a wardrobe. 

To your south is the living room.

You can see a Bunkbed here.

>wait until 3:00 am
You yawn until 3:00 am.

* * *

Calico City
A peek into Calico Life by TurtleCorn Productions
Release 1 / Serial number 220704 / Inform 7 build 6M62 (I6/v6.34 lib 6/12N) SD

Bunnies' Bedroom
The Bunnies' Bedroom has a bunkbed against one wall for you and Liam Bunny, and a bed for each parent. Next to the bunkbed is a desk, and in front of the beds is a wardrobe. 

To your south is the living room.

You can see a Bunkbed here.

>x liam's bed
Liam's bed is blue, and you see a stuffed turtle there.

As you examine Liam's Bed, you notice that there is a seam around part of the wall in the shape of a door. You tap on it, and the door swings open!

>x liam's bed
Liam's bed is blue, and you see a stuffed turtle there.

>x wall
The wallpaper is neatly decorated with flowers. A panel in the wall, just big enough to fit through, has been opened to reveal a hidden door to the east.

* * *

Calico City
A peek into Calico Life by TurtleCorn Productions
Release 1 / Serial number 220704 / Inform 7 build 6M62 (I6/v6.34 lib 6/12N) SD

Bunnies' Bedroom
The Bunnies' Bedroom has a bunkbed against one wall for you and Liam Bunny, and a bed for each parent. Next to the bunkbed is a desk, and in front of the beds is a wardrobe. 

To your south is the living room.

You can see a Bunkbed here.

>x wallpaper
The wallpaper is neatly decorated with flowers.

As you examine the wallpaper, you notice that there is a seam around part of the wall in the shape of a door. You tap on it, and the door swings open!

>x wallpaper
The wallpaper is neatly decorated with flowers. A panel in the wall, just big enough to fit through, has been opened to reveal a hidden door to the east.

>close door
You close the hidden door.

>x wallpaper
The wallpaper is neatly decorated with flowers. Part of the wall seems to have a seam around it.

>open door
You open the hidden door.

>e
Liam Bunny's Stash
It seems like a place that Liam Bunny has been using for a while to store candy and snacks.

* * *

Calico City
A peek into Calico Life by TurtleCorn Productions
Release 1 / Serial number 220704 / Inform 7 build 6M62 (I6/v6.34 lib 6/12N) SD

Bunnies' Bedroom
The Bunnies' Bedroom has a bunkbed against one wall for you and Liam Bunny, and a bed for each parent. Next to the bunkbed is a desk, and in front of the beds is a wardrobe. 

To your south is the living room.

You can see a Bunkbed here.

>z
Time passes.

>z
Time passes.

arrived
1

>z
Time passes.

You'll have to say which compass direction to go in.
I didn't understand that instruction.
arrived
2

>z
Time passes.

You'll have to say which compass direction to go in.
I didn't understand that instruction.
arrived
3

>z
Time passes.

You'll have to say which compass direction to go in.
I didn't understand that instruction.
arrived
4

>z
Time passes.

You'll have to say which compass direction to go in.
I didn't understand that instruction.
arrived
5

* * *

>z
Time passes.

>s
Bunnies' Living Room
The Bunnies' Living Room has a big couch, with two small couches on either side. There is a small coffee table with the TV as well as some toys and books.

To your west is the front door and exit, and there are stairs leading up to the dining room and kitchen. To your north is the bedroom.

Daddy Bunny arrives from the north.

>z
Time passes.

Daddy Bunny goes up.

>z
Time passes.

>s
You can't go that way.

You'll have to say which compass direction to go in.
I didn't understand that instruction.

>n
Bunnies' Bedroom
The Bunnies' Bedroom has a bunkbed against one wall for you and Liam Bunny, and a bed for each parent. Next to the bunkbed is a desk, and in front of the beds is a wardrobe.

To your south is the living room.

You'll have to say which compass direction to go in.
I didn't understand that instruction.

>s
Bunnies' Living Room
The Bunnies' Living Room has a big couch, with two small couches on either side. There is a small coffee table with the TV as well as some toys and books.

To your west is the front door and exit, and there are stairs leading up to the dining room and kitchen. To your north is the bedroom.

You'll have to say which compass direction to go in.
I didn't understand that instruction.

>s
You can't go that way.

You'll have to say which compass direction to go in.
I didn't understand that instruction.

>up
Bunnies' Dining Room
The dining room table and chairs are wooden, and painted red. On the wall is a broom to help clean up the big messes that Liam Bunny makes. Along the wall is the kitchen.

To your south is the bathroom, and there are stairs leading down to the living room.

You'll have to say which compass direction to go in.
I didn't understand that instruction.

* * *

>z
Time passes.

>z
Time passes.

Daddy Bunny arrives from above.

>z
Time passes.

Daddy Bunny goes north.

>z
Time passes.

Daddy Bunny arrives from the north.

>z
Time passes.

Daddy Bunny goes up.

* * *

>z
Time passes.

Daddy Bunny arrives from above.

I beg your pardon?

* * *

>now the destination of Daddy Bunny is the Bunnies' Bedroom;
That's not a verb I recognise.

>e
You can't go that way.

Daddy Bunny goes north.

>n
Bunnies' Bedroom
The Bunnies' Bedroom has a bunkbed against one wall for you and Liam Bunny, and a bed for each parent. Next to the bunkbed is a desk, and in front of the beds is a wardrobe.

To your south is the living room.

You can see Daddy Bunny here.

Daddy Bunny goes south.

>s
Bunnies' Living Room
The Bunnies' Living Room has a big couch, with two small couches on either side. There is a small coffee table with the TV as well as some toys and books.

To your west is the front door and exit, and there are stairs leading up to the dining room and kitchen. To your north is the bedroom.

You can see Daddy Bunny here.

Daddy Bunny goes up.

>up
Bunnies' Dining Room
The dining room table and chairs are wooden, and painted red. On the wall is a broom to help clean up the big messes that Liam Bunny makes. Along the wall is the kitchen.

To your south is the bathroom, and there are stairs leading down to the living room.

You can see Daddy Bunny here.

Daddy Bunny goes south.

>s
Bunnies' Bathroom
The bathroom has all the normal things in a bathroom. On the wall is a laundry machine. In the bathtub is a toy bath turtle.

To the north is the kitchen and dining room.

You can see Daddy Bunny here.

Daddy Bunny goes north.

* * *

>z
Time passes.

>talk
That's not a verb I recognise.

>talk to Daddy Bunny
That's not a verb I recognise.

>ask Daddy Bunny about food
(Daddy Bunny) Hi Maeve! How are you? I'm just cleaning the house.

>z
Time passes.

Daddy Bunny vacuums the floor.

Daddy Bunny goes south.

* * *

>z
Time passes.

>x daddy bunny
(Daddy Bunny) Hi Maeve! How are you? I'm just going to the Bunnies' Bathroom.

* * *

>z
Time passes.

>z
Time passes.

Bunnies' Garden.

>z
Time passes.

Bunnies' Garden.

I beg your pardon?

* * *

>z
Time passes.

>z
Time passes.

You'll have to say which compass direction to go in.
I didn't understand that instruction.

>z
Time passes.

You'll have to say which compass direction to go in.
I didn't understand that instruction.

>wait
Time passes.

You'll have to say which compass direction to go in.
I didn't understand that instruction.

>wait
Time passes.

You'll have to say which compass direction to go in.
I didn't understand that instruction.

>s
Bunnies' Living Room
The Bunnies' Living Room has a big couch, with two small couches on either side. There is a small coffee table with the TV as well as some toys and books.

To your west is the front door and exit, and there are stairs leading up to the dining room and kitchen. To your north is the bedroom.

You'll have to say which compass direction to go in.
I didn't understand that instruction.

>n
Bunnies' Bedroom
The Bunnies' Bedroom has a bunkbed against one wall for you and Liam Bunny, and a bed for each parent. Next to the bunkbed is a desk, and in front of the beds is a wardrobe.

To your south is the living room.

You'll have to say which compass direction to go in.
I didn't understand that instruction.

>stop
That's not a verb I recognise.

* * *

>z
Time passes.

Bunnies' Garden.

>z
Time passes.

Country Road

>look at daddy bunny
You see nothing special about Daddy Bunny.

(Daddy Bunny) Sorry, but could you move? I need to clean this room.

>s
Bunnies' Living Room
The Bunnies' Living Room has a big couch, with two small couches on either side. There is a small coffee table with the TV as well as some toys and books.

To your west is the front door and exit, and there are stairs leading up to the dining room and kitchen. To your north is the bedroom.

Daddy Bunny arrives from the Bunnies' Bedroom and begins vacuuming and cleaning.

>i
You are carrying nothing.

Daddy Bunny walks leaves the room and heads to the Bunnies' Dining Room.

>z
Time passes.

* * *

>z
Time passes.

Country Road

>z
Time passes.

Banks of the Calico River

>w
You can't go that way.

* * *

>e
You can't go that way.

>s
Bunnies' Living Room
The Bunnies' Living Room has a big couch, with two small couches on either side. There is a small coffee table with the TV as well as some toys and books.

To your west is the front door and exit, and there are stairs leading up to the dining room and kitchen. To your north is the bedroom.

>up
Bunnies' Dining Room
The dining room table and chairs are wooden, and painted red. On the wall is a broom to help clean up the big messes that Liam Bunny makes. Along the wall is the kitchen.

To your south is the bathroom, and there are stairs leading down to the living room.

You can see Daddy Bunny here.

>z
Time passes.

* * *

>z
Time passes.

Banks of the Calico River

>z
Time passes.

Twisty N. Books Airport

>z
Time passes.

Twisty N. Books Airport

>s
Bunnies' Living Room
The Bunnies' Living Room has a big couch, with two small couches on either side. There is a small coffee table with the TV as well as some toys and books.

To your west is the front door and exit, and there are stairs leading up to the dining room and kitchen. To your north is the bedroom.

* * *

>z
Time passes.

Twisty N. Books Airport

>z
Time passes.

Calico City Garden

>z
Time passes.

Sunriver Bowling Alley

>z
Time passes.

Sunriver Bowling Alley

>s
Bunnies' Living Room
The Bunnies' Living Room has a big couch, with two small couches on either side. There is a small coffee table with the TV as well as some toys and books.

To your west is the front door and exit, and there are stairs leading up to the dining room and kitchen. To your north is the bedroom.

>up
Bunnies' Dining Room
The dining room table and chairs are wooden, and painted red. On the wall is a broom to help clean up the big messes that Liam Bunny makes. Along the wall is the kitchen.

To your south is the bathroom, and there are stairs leading down to the living room.

>s
Bunnies' Bathroom
The bathroom has all the normal things in a bathroom. On the wall is a laundry machine. In the bathtub is a toy bath turtle.

To the north is the kitchen and dining room.

>z
Time passes.

>z
Time passes.

Daddy Bunny arrives from the north.

>z
Time passes.

Daddy Bunny mops the floor.

>z
Time passes.

Daddy Bunny vacuums the floor.

Daddy Bunny goes north.

* * *

>z
Time passes.

Sunriver Bowling Alley

>z
Time passes.

Calico City Garden

>z
Time passes.

Twisty N. Books Airport

>z
Time passes.

Banks of the Calico River

>z
Time passes.

Country Road

>z
Time passes.

Christmas Party Area

>z
Time passes.

Christmas Theater

>z
Time passes.

Christmas Dance Party

>z
Time passes.

FunFun Meadow

>z
Time passes.

FunFun Meadow

>z
Time passes.

Sundale Calico Grocery Store

>z
Time passes.

Sundale Calico Grocery Store

>z
Time passes.

FunFun Meadow

>z
Time passes.

Calico Public Library

>z
Time passes.

Calico Public Library

>z
Time passes.

FunFun Meadow

>z
Time passes.

Christmas Dance Party

>z
Time passes.

Christmas Theater

>z
Time passes.

Carousel

>z
Time passes.

Bunnies' Garden.

>z
Time passes.

Bunnies' Living Room

>z
Time passes.

Bunnies' Living Room

>s
Bunnies' Living Room
The Bunnies' Living Room has a big couch, with two small couches on either side. There is a small coffee table with the TV as well as some toys and books.

To your west is the front door and exit, and there are stairs leading up to the dining room and kitchen. To your north is the bedroom.

You can see Daddy Bunny here.

Daddy Bunny mops the floor.

Daddy Bunny goes west.

Bunnies' Garden.

* * *

>z
Time passes.

Bunnies' Living Room

>z
Time passes.

Bunnies' Garden. 0

>z
Time passes.

Bunnies' Garden. 0

>z
Time passes.

Country Road 0

>z
Time passes.

Banks of the Calico River 0

>z
Time passes.

Twisty N. Books Airport 0

>z
Time passes.

Twisty N. Books Airport 0

>z
Time passes.

Calico City Garden 0

I beg your pardon?

>z
Time passes.

Sunriver Bowling Alley 0

>z
Time passes.

Sunriver Bowling Alley 1

>z
Time passes.

Sunriver Bowling Alley 2

>z
Time passes.

Sunriver Bowling Alley 3

>z
Time passes.

Sunriver Bowling Alley 4

* * *

Calico City
A peek into Calico Life by TurtleCorn Productions
Release 1 / Serial number 220704 / Inform 7 build 6M62 (I6/v6.34 lib 6/12N) SD

Bunnies' Bedroom
The Bunnies' Bedroom has a bunkbed against one wall for you and Liam Bunny, and a bed for each parent. Next to the bunkbed is a desk, and in front of the beds is a wardrobe. 

To your south is the living room.

You can see a Bunkbed here.

>zz
That's not a verb I recognise.

>z
Time passes.

Daddy Bunny arrives from the south.

I beg your pardon?

>z
Time passes.

Daddy Bunny goes south.

>z
Time passes.